abandoned	VBD	abandon
abandoned	VBN	abandon
abandoning	VBG	abandon
abandons	VBZ	abandon
abandon	VBP	abandon
abated	VBN	abate
abates	VBZ	abate
abating	VBG	abate
abetted	VBN	abet
abetting	VBG	abet
abilities	NNS	ability
abolished	VBN	abolish
abolishing	VBG	abolish
aborted	VBN	abort
abortions	NNS	abortion
abounded	VBD	abound
abounds	VBZ	abound
abound	VBP	abound
absences	NNS	absence
absolving	VBG	absolve
absorbed	VBD	absorb
absorbed	VBN	absorb
absorbers	NNS	absorber
absorbing	VBG	absorb
absorbs	VBZ	absorb
abstained	VBD	abstain
abstracts	NNS	abstract
abused	VBN	abuse
abuses	NNS	abuse
abusing	VBG	abuse
accelerated	VBD	accelerate
accelerated	VBN	accelerate
accelerates	VBZ	accelerate
accelerating	VBG	accelerate
acceptances	NNS	acceptance
accepted	VBD	accept
accepted	VBN	accept
accepting	VBG	accept
accepts	VBZ	accept
accept	VBP	accept
accessories	NNS	accessory
accidents	NNS	accident
accommodated	VBN	accommodate
accommodating	VBG	accommodate
accommodations	NNS	accommodation
accompanied	VBN	accompany
accompanies	VBZ	accompany
accompanying	VBG	accompany
accomplished	VBN	accomplish
accomplishing	VBG	accomplish
accomplishments	NNS	accomplishment
accorded	VBD	accord
according	VBG	accord
accords	NNS	accord
accountants	NNS	accountant
accounted	VBD	account
accounted	VBN	account
accounting	NNP	accounting
accounting	VBG	account
accounts	NNS	account
accounts	VBZ	account
account	VBP	account
accreted	VBN	accrete
accrued	VBN	accrue
accrues	NNS	accrue
accruing	VBG	accrue
accumulated	VBN	accumulate
accumulate	VBP	accumulate
accumulating	VBG	accumulate
accusations	NNS	accusation
accused	VBD	accuse
accused	VBN	accuse
accusers	NNS	accuser
accuses	VBZ	accuse
accuse	VBP	accuse
accusing	VBG	accuse
accustomed	VBN	accustom
achieved	VBD	achieve
achieved	VBN	achieve
achievements	NNS	achievement
achieves	VBZ	achieve
achieve	VBP	achieve
achieving	VBG	achieve
aching	VBG	ache
acidified	VBN	acidify
acknowledged	VBD	acknowledge
acknowledged	VBN	acknowledge
acknowledges	VBZ	acknowledge
acknowledge	VBP	acknowledge
acknowledging	VBG	acknowledge
acquainted	VBN	acquaint
acquiesced	VBD	acquiesce
acquired	VBD	acquire
acquired	VBN	acquire
acquirers	NNS	acquirer
acquires	VBZ	acquire
acquiring	VBG	acquire
acquisitions	NNS	acquisition
acquitted	VBN	acquit
acres	NNS	acres
acted	VBD	act
acted	VBN	act
acting	VBG	act
actions	NNS	action
activated	VBN	activate
activists	NNS	activist
activities	NNS	activity
activity	NNP	activity
actors	NNS	actor
acts	NNS	acts
acts	VBZ	act
act	VBP	act
adapted	VBD	adapt
adapted	VBN	adapt
adapting	VBG	adapt
added	VBD	add
added	VBN	add
addicts	NNS	addict
adding	VBG	add
additions	NNS	addition
addressed	VBD	address
addressed	VBN	address
addresses	VBZ	address
addressing	VBG	address
address	VBZ	address
adds	VBZ	add
add	VBP	add
adjourned	VBD	adjourn
adjusted	VBN	adjust
adjusters	NNS	adjuster
adjusting	VBG	adjust
adjustments	NNS	adjustment
adjusts	VBZ	adjust
adjust	VBP	adjust
administered	VBN	administer
administers	VBZ	administer
administrators	NNS	administrator
admired	VBD	admire
admirers	NNS	admirer
admires	VBZ	admire
admissions	NNS	admission
admits	VBZ	admit
admitted	VBD	admit
admitted	VBN	admit
admitting	VBG	admit
admit	VBP	admit
admonishing	VBG	admonish
adopted	VBD	adopt
adopted	VBN	adopt
adopting	VBG	adopt
adopts	VBZ	adopt
adopt	VBP	adopt
adorned	VBD	adorn
adorned	VBN	adorn
ads	NNS	ad
advanced	VBD	advance
advanced	VBN	advance
advancements	NNS	advancement
advancers	NNS	advancer
advances	NNS	advance
advancing	VBG	advance
advantages	NNS	advantage
adversaries	NNS	adversary
advertised	VBD	advertise
advertised	VBN	advertise
advertisements	NNS	advertisement
advertisers	NNS	advertiser
advertises	VBZ	advertise
advertise	VBP	advertise
advertising	VBG	advertise
advised	VBD	advise
advised	VBN	advise
advisers	NNS	adviser
advises	VBZ	advise
advise	VBP	advise
advising	VBG	advise
advisories	NNS	advisory
advocated	VBN	advocate
advocates	NNS	advocate
advocate	VBP	advocate
advocating	VBG	advocate
affairs	NNS	affairs
affected	VBD	affect
affected	VBN	affect
affecting	VBG	affect
affections	NNS	affection
affects	VBZ	affect
affect	VBP	affect
affidavits	NNS	affidavit
affiliated	VBN	affiliate
affiliates	NNS	affiliate
affiliating	VBG	affiliate
affirmed	VBD	affirm
affirming	VBG	affirm
afflicted	VBN	afflict
afflicts	VBZ	afflict
afforded	VBN	afford
aftereffects	NNS	aftereffect
aftershocks	NNS	aftershock
aged	VBN	age
agendas	NNS	agenda
agents	NNS	agent
ages	NNS	age
aggravated	VBN	aggravate
aggravates	VBZ	aggravate
aggravating	VBG	aggravate
aging	VBG	age
agitated	VBN	agitate
agreed	VBD	agree
agreed	VBN	agree
agreeing	VBG	agree
agreements	NNS	agreement
agrees	VBZ	agree
agree	VBP	agree
aided	VBD	aid
aided	VBN	aid
aides	NNS	aides
aiding	VBG	aid
aids	NNS	aids
aids	VBZ	aid
ailing	VBG	ail
aimed	VBN	aim
aiming	VBG	aim
aim	NNP	aim
aims	NNS	aim
aims	VBZ	aim
aim	VBP	aim
aired	VBD	air
aired	VBN	air
airing	VBG	air
airlifted	VBN	airlift
airlifting	VBG	airlift
airs	NNS	air
airs	VBZ	air
alarmed	VBN	alarm
alarms	NNS	alarm
albums	NNS	album
alchemists	NNS	alchemist
alerted	VBD	alert
alerting	VBG	alert
alienates	VBZ	alienate
alienating	VBG	alienate
aligned	VBD	align
aligned	VBN	align
allayed	VBN	allay
allegations	NNS	allegation
alleged	VBD	allege
alleged	VBN	allege
alleges	VBZ	allege
allege	VBP	allege
alleging	VBG	allege
alleviating	VBG	alleviate
alliances	NNS	alliance
allied	VBD	ally
allies	NNS	allies
allocated	VBD	allocate
allocated	VBN	allocate
allocate	VBP	allocate
allocations	NNS	allocation
allotments	NNS	allotment
allowances	NNS	allowance
allowed	VBD	allow
allowed	VBN	allow
allowing	VBG	allow
allows	VBZ	allow
allow	VBP	allow
alluded	VBD	allude
allusions	NNS	allusion
allying	VBG	ally
altered	VBD	alter
altered	VBN	alter
altering	VBG	alter
alternating	VBG	alternate
alternatives	NNS	alternative
alter	NNP	alter
alter	VBP	alter
amassed	VBN	amass
amasses	VBZ	amass
amazed	VBN	amaze
ambassador	NNP	ambassador
ambitions	NNS	ambition
amble	VBP	amble
ambushed	VBD	ambush
amended	VBD	amend
amended	VBN	amend
amending	VBG	amend
amendments	NNS	amendment
amenities	NNS	amenities
americanized	VBD	americanize
amounted	VBD	amount
amounts	NNS	amount
amounts	VBZ	amount
amount	VBP	amount
amplified	VBN	amplify
amused	VBN	amuse
analysis	NNP	analysis
analysts	NNS	analyst
analyzed	VBD	analyze
analyzing	VBG	analyze
anchored	VBN	anchor
anchor	VBP	anchor
angered	VBD	anger
angered	VBN	anger
angering	VBG	anger
angles	NNS	angle
animated	VBN	animate
annals	NNS	annals
anniversary	NNP	anniversary
announced	VBD	announce
announced	VBN	announce
announcements	NNS	announcement
announces	VBZ	announce
announcing	VBG	announce
annoyed	VBD	annoy
annoyed	VBN	annoy
anointing	NNP	anoint
answered	VBD	answer
answered	VBN	answer
answers	NNS	answer
answers	VBZ	answer
antagonists	NNS	antagonist
anthers	NNS	anther
anticipated	VBD	anticipate
anticipated	VBN	anticipate
anticipates	VBZ	anticipate
anticipate	VBP	anticipate
anticipating	VBG	anticipate
antics	NNS	antic
anxieties	NNS	anxiety
apartments	NNS	apartment
apologies	NNS	apology
apologists	NNS	apologist
apologized	VBN	apologize
apologizes	VBZ	apologize
appalled	VBN	appall
appealed	VBD	appeal
appealed	VBN	appeal
appealing	VBG	appeal
appeals	NNS	appeal
appeal	VBP	appeal
appearances	NNS	appearance
appeared	VBD	appear
appeared	VBN	appear
appearing	VBG	appear
appears	VBZ	appear
appear	VBP	appear
appeased	VBD	appease
appended	VBN	append
applauded	VBD	applaud
applauding	VBG	applaud
applauds	VBZ	applaud
applicants	NNS	applicant
applications	NNS	application
applied	VBD	apply
applied	VBN	apply
applies	VBZ	apply
applying	VBG	apply
apply	VBP	apply
appointed	VBD	appoint
appointed	VBN	appoint
appointees	NNS	appointee
appointments	NNS	appointment
appraisals	NNS	appraisal
appraised	VBN	appraise
appraisers	NNS	appraiser
appreciated	VBD	appreciate
appreciated	VBN	appreciate
appreciates	VBZ	appreciate
appreciate	VBP	appreciate
appreciating	VBG	appreciate
apprehensions	NNS	apprehension
apprised	VBN	apprise
approached	VBD	approach
approached	VBN	approach
approaches	NNS	approach
approaches	VBZ	approach
approaching	VBG	approach
approach	VBP	approach
appropriated	VBN	appropriate
appropriations	NNS	appropriation
approvals	NNS	approval
approved	VBD	approve
approved	VBN	approve
approves	VBZ	approve
approve	VBP	approve
approving	VBG	approve
arbitragers	NNS	arbitrager
arbitrates	VBZ	arbitrate
arched	VBN	arch
architects	NNS	architect
area	NNP	area
areas	NNS	area
arenas	NNS	arena
argued	VBD	argue
argued	VBN	argue
argues	VBZ	argue
argue	VBP	argue
arguing	VBG	argue
arguments	NNS	argument
arisen	VBN	arise
arises	NNS	arise
arise	VBP	arise
arising	VBG	arise
armed	VBN	arm
armies	NNS	army
armpits	NNS	armpit
arms	NNS	arms
arose	VBD	arise
aroused	VBN	arouse
arouses	VBZ	arouse
arousing	VBG	arouse
arranged	VBD	arrange
arranged	VBN	arrange
arranges	VBZ	arrange
arranging	VBG	arrange
arrears	NNS	arrears
arrested	VBN	arrest
arrest	NNP	arrest
arrests	NNS	arrest
arrivals	NNS	arrival
arrived	VBD	arrive
arrived	VBN	arrive
arrives	VBZ	arrive
arrive	VBP	arrive
arriving	VBG	arrive
arsenals	NNS	arsenal
arteries	NNS	artery
articles	NNS	article
artists	NNS	artist
ascending	VBG	ascend
ascribed	VBD	ascribe
asked	VBD	ask
asked	VBN	ask
asking	VBG	ask
ask	NNP	ask
asks	VBZ	ask
ask	VBP	ask
aspects	NNS	aspect
aspired	VBN	aspire
aspire	VBP	aspire
aspiring	VBG	aspire
assailed	VBD	assail
assassinated	VBD	assassinate
assassinating	VBG	assassinate
assassinations	NNS	assassination
assaults	NNS	assault
assembled	VBD	assemble
assembled	VBN	assemble
assemblies	NNS	assembly
assembling	VBG	assemble
assembly	NNP	assembly
asserted	VBD	assert
asserting	VBG	assert
assertions	NNS	assertion
asserts	VBZ	assert
assert	VBP	assert
asses	NNS	ass
assessed	VBD	assess
assessed	VBN	assess
assessing	VBG	assess
assessments	NNS	assessment
assets	NNS	assets
assigned	VBN	assign
assisted	VBN	assist
assisting	VBG	assist
assists	VBZ	assist
associated	VBN	associate
associates	NNS	associate
associating	VBG	associate
association	NNP	association
associations	NNS	association
assumed	VBD	assume
assumed	VBN	assume
assumes	VBZ	assume
assume	VBP	assume
assuming	VBG	assume
assumptions	NNS	assumption
assurances	NNS	assurance
assured	VBD	assure
assured	VBN	assure
assures	VBZ	assure
assuring	VBG	assure
astounds	VBZ	astound
ate	NNP	eat
ate	VBD	eat
atoms	NNS	atom
attached	VBD	attach
attached	VBN	attach
attaches	VBZ	attach
attaching	VBG	attach
attacked	VBD	attack
attacked	VBN	attack
attackers	NNS	attacker
attacking	VBG	attack
attacks	NNS	attack
attained	VBN	attain
attempted	VBD	attempt
attempted	VBN	attempt
attempting	VBG	attempt
attempts	NNS	attempt
attempts	VBZ	attempt
attempt	VBP	attempt
attendants	NNS	attendant
attended	VBD	attend
attended	VBN	attend
attendees	NNS	attendee
attending	VBG	attend
attends	VBZ	attend
attend	VBP	attend
attests	VBZ	attest
attitudes	NNS	attitude
attorneys	NNS	attorney
attracted	VBD	attract
attracted	VBN	attract
attracting	VBG	attract
attractions	NNS	attraction
attracts	VBZ	attract
attract	VBP	attract
attributed	VBD	attribute
attributed	VBN	attribute
attributes	NNS	attribute
attributes	VBZ	attribute
attribute	VBP	attribute
attributing	VBG	attribute
auctioned	VBD	auction
auctioned	VBN	auction
auctions	NNS	auction
audiences	NNS	audience
audited	VBN	audit
auditors	NNS	auditor
audits	NNS	audit
authored	VBN	author
authorities	NNS	authorities
authorizations	NNS	authorization
authorized	VBD	authorize
authorized	VBN	authorize
authorizing	VBG	authorize
author	NNP	author
authors	NNS	author
autographed	VBN	autograph
autographs	NNS	autograph
automated	VBN	automate
automating	VBG	automate
averaged	VBD	average
averaged	VBN	average
averages	NNS	average
averaging	VBG	average
averred	VBN	aver
averted	VBN	avert
averting	VBG	avert
averts	VBZ	avert
avoided	VBD	avoid
avoided	VBN	avoid
avoiding	VBG	avoid
avoids	NNS	avoid
avoid	VBP	avoid
awaited	VBD	await
awaiting	VBG	await
awaits	VBZ	await
await	VBP	await
awakened	VBN	awaken
awarded	VBD	award
awarded	VBN	award
awarding	VBG	award
awards	NNS	award
awoke	VBD	awake
axioms	NNS	axiom
backed	VBD	back
backed	VBN	back
backers	NNS	backer
backfired	VBN	backfire
backgrounds	NNS	background
backing	VBG	back
backlogs	NNS	backlog
backpedaling	VBG	backpedal
backs	NNS	back
backs	VBZ	back
back	VBP	back
badges	NNS	badge
baggers	NNS	bagger
bags	NNS	bag
bailed	VBD	bail
bailing	VBG	bail
bailouts	NNS	bailouts
balanced	VBN	balance
balances	NNS	balance
balances	VBZ	balance
balancing	VBG	balance
balked	VBD	balk
balking	VBG	balk
ballooned	VBD	balloon
ballooned	VBN	balloon
balloons	NNS	balloon
ballyhooed	VBN	ballyhoo
banded	VBN	band
bandied	VBN	bandy
bangs	VBZ	bang
banished	VBN	banish
bankers	NNS	banker
bank	NNP	bank
bankroll	VBP	bankroll
banned	VBD	ban
banned	VBN	ban
banning	VBG	ban
bans	NNS	ban
bargained	VBD	bargain
bargains	NNS	bargain
barges	NNS	barge
barons	NNS	baron
barred	VBD	bar
barred	VBN	bar
barrels	NNS	barrels
barriers	NNS	barrier
barring	VBG	bar
bars	VBZ	bar
bartered	VBN	barter
bartering	VBG	barter
based	VBD	base
based	VBN	base
bases	NNS	base
base	VBP	base
bashing	VBG	bash
basing	VBG	base
baskets	NNS	basket
bastions	NNS	bastion
batches	NNS	batch
bathrooms	NNS	bathroom
battered	VBN	batter
battering	VBG	batter
battled	VBD	battle
battlements	NNS	battlement
battles	NNS	battle
battle	VBP	battle
battling	VBG	battle
beamed	VBN	beam
beaming	VBG	beam
beams	VBZ	beam
bearings	NNS	bearing
bearing	VBG	bear
bears	NNS	bear
bears	VBZ	bear
bear	VBP	bear
beaten	VBN	beat
beating	VBG	beat
beats	VBZ	beat
beat	VBD	beat
beat	VBP	beat
became	VBD	become
becomes	VBZ	become
become	VBN	become
become	VBP	become
becoming	VBG	become
bedeviled	VBN	bedevil
beefed	VBD	beef
beefed	VBN	beef
beefing	VBG	beef
befallen	VBN	befall
befall	VBP	befall
befriended	VBN	befriend
began	VBD	begin
begged	VBN	beg
begging	VBG	beg
beginning	VBG	begin
begins	VBZ	begin
begin	VBP	begin
begs	VBZ	beg
begun	VBN	begin
behaved	VBD	behave
behaves	VBZ	behave
behaving	VBG	behave
beheading	VBG	behead
beings	NNS	being
being	VBG	be
belied	VBD	belie
beliefs	NNS	belief
belie	VBP	belie
believed	VBD	believe
believed	VBN	believe
believes	VBZ	believe
believe	VBP	believe
believing	VBG	believe
belly	VBD	belly
belonged	VBD	belong
belonging	VBG	belong
belongs	VBZ	belong
belong	VBP	belong
bemoaning	VBG	bemoan
bending	VBG	bend
beneficiaries	NNS	beneficiary
benefited	VBD	benefit
benefited	VBN	benefit
benefiting	VBG	benefit
benefit	NNP	benefit
benefits	NNS	benefit
benefits	VBZ	benefit
benefit	VBP	benefit
bequeathed	VBD	bequeath
bequests	NNS	bequest
berated	VBD	berate
beset	VBN	beset
besieged	VBN	besiege
bested	VBN	best
bestowed	VBN	bestow
betas	NNS	beta
betrayed	VBN	betray
bets	NNS	bet
betters	NNS	better
betting	VBG	bet
bet	VBD	bet
bet	VBP	bet
beware	NNP	beware
bewildered	VBN	bewilder
bewildering	VBG	bewilder
bewitched	VBN	bewitch
biases	NNS	bias
bickered	VBN	bicker
bidders	NNS	bidder
bidding	VBG	bid
bids	NNS	bid
bid	VBD	bid
bid	VBN	bid
bid	VBP	bid
biking	NNP	bike
billed	VBD	bill
billed	VBN	bill
billings	NNS	billings
billing	VBG	bill
billions	NNS	billion
billowing	VBG	billow
bills	NNP	bill
bills	NNS	bill
binding	VBG	bind
birthdays	NNS	birthday
bites	VBZ	bite
biting	VBG	bite
bits	NNS	bit
bitten	NNP	bite
blacked	VBN	black
blackened	VBN	blacken
blackmailed	VBN	blackmail
blackmailing	VBG	blackmail
blamed	VBD	blame
blamed	VBN	blame
blames	VBZ	blame
blame	VBP	blame
blaming	VBG	blame
blanketed	VBD	blanket
blared	VBD	blare
blasted	VBD	blast
blazing	VBG	blaze
bleeding	VBG	bleed
blending	VBG	blend
blends	NNS	blend
blessed	VBN	bless
blessings	NNS	blessing
blew	VBD	blow
blindfolded	VBN	blindfold
blinked	VBD	blink
blips	NNS	blip
blitzes	NNS	blitz
blocked	VBD	block
blocked	VBN	block
blocking	VBG	block
blocks	NNS	block
block	VBP	block
bloc	NNP	bloc
bloodied	VBN	bloody
blooming	VBG	bloom
blossomed	VBD	blossom
blossomed	VBN	blossom
blotting	VBG	blot
blowing	VBG	blow
blown	VBN	blow
blows	NNS	blow
bludgeoned	VBN	bludgeon
blundered	VBD	blunder
blunted	VBN	blunt
blurred	VBD	blur
blurring	VBG	blur
blurt	VBP	blurt
boardrooms	NNS	boardroom
boards	NNS	boards
boasted	VBD	boast
boasted	VBN	boast
boasts	VBZ	boast
boating	VBG	boat
bodes	VBZ	bode
bodies	NNS	body
bogging	VBG	bog
bolstered	VBN	bolster
bolstering	VBG	bolster
bolsters	NNS	bolster
bolted	VBN	bolt
bombarded	VBD	bombard
bombed	VBN	bomb
bombings	NNS	bombing
bonded	VBN	bond
bond	NNP	bond
bonds	NNS	bond
boned	VBN	bone
bones	NNS	bones
bonuses	NNS	bonus
booked	VBD	book
booked	VBN	book
bookings	NNS	booking
booklets	NNS	booklet
books	NNS	book
boomed	VBD	boom
boomed	VBN	boom
booming	VBG	boom
booms	NNS	boom
boosted	VBD	boost
boosted	VBN	boost
boosters	NNS	booster
boosting	VBG	boost
boosts	NNS	boost
boosts	VBZ	boost
boost	VBP	boost
bootlegged	VBN	bootleg
bordered	VBD	border
bordering	VBG	border
borders	NNS	border
bored	VBN	bore
bore	VBD	bear
boring	VBG	bore
borne	VBN	bear
born	VBN	bear
borrowed	VBD	borrow
borrowed	VBN	borrow
borrowers	NNS	borrower
borrowings	NNS	borrowing
borrowing	VBG	borrow
borrows	VBZ	borrow
borrow	VBP	borrow
botched	VBN	botch
bothered	VBD	bother
bothered	VBN	bother
bothering	VBG	bother
bottled	VBN	bottle
bottlers	NNS	bottler
bottles	NNS	bottle
bottling	VBG	bottle
bottomed	VBN	bottom
bottoming	VBG	bottom
bottoms	NNS	bottom
bought	VBD	buy
bought	VBN	buy
bounced	VBD	bounce
bounces	NNS	bounce
bounce	VBP	bounce
bouncing	VBG	bounce
boundaries	NNS	boundary
bounding	VBG	bound
bounds	NNS	bound
bound	VBN	bind
bouts	NNS	bout
bowed	VBD	bow
bowing	VBG	bow
bowling	VBG	bowl
bowls	VBZ	bowl
bowl	VBP	bowl
boxes	NNS	box
boycotted	VBN	boycott
boys	NNS	boy
braced	VBN	brace
bracing	VBG	brace
brags	VBZ	brag
brains	NNS	brain
branched	VBN	branch
branches	NNS	branch
branching	VBG	branch
brands	NNS	brand
brawls	NNS	brawl
breached	VBD	breach
breached	VBN	breach
breaches	NNS	breach
breaded	VBN	bread
breakdowns	NNS	breakdown
breakers	NNS	breakers
breaking	VBG	break
breaks	NNS	break
breaks	VBZ	break
breakthroughs	NNS	breakthrough
break	VBP	break
breasts	NNS	breast
breathed	VBD	breathe
breathing	VBG	breathe
bred	VBD	breed
bred	VBN	breed
breeders	NNS	breeder
breeding	VBG	breed
brewed	VBN	brew
brewing	VBG	brew
bribed	VBD	bribe
bribes	NNS	bribe
bribing	VBG	bribe
bridges	NNS	bridges
bridging	VBG	bridge
briefed	VBN	brief
briefings	NNS	briefing
briefs	NNS	briefs
brigades	NNS	brigade
brightened	VBD	brighten
brightening	VBG	brighten
brimmed	VBD	brim
bringing	VBG	bring
brings	VBZ	bring
bring	VBP	bring
bristled	VBD	bristle
bristles	VBZ	bristle
broadcasters	NNS	broadcaster
broadcasting	VBG	broadcast
broadcasts	NNS	broadcast
broadcast	VBD	broadcast
broadcast	VBN	broadcast
broadened	VBD	broaden
broadening	VBG	broaden
broadens	VBZ	broaden
brochures	NNS	brochure
broken	VBN	break
brokerages	NNS	brokerage
brokers	NNS	broker
broke	VBD	break
brothers	NNS	brother
brought	VBD	bring
brought	VBN	bring
bruised	VBN	bruise
bruising	VBG	bruise
brushed	VBD	brush
brushed	VBN	brush
brushes	NNS	brush
brushing	VBG	brush
bucked	VBD	buck
buckets	NNS	bucket
bucking	VBG	buck
buckled	VBN	buckle
buckling	VBG	buckle
buddies	NNS	buddy
budding	VBG	bud
budged	VBD	budge
budged	VBN	budge
budgeted	VBN	budget
budgets	NNS	budget
buffeted	VBN	buffet
buffs	NNS	buff
builders	NNS	builder
building	NNP	build
building	VBG	build
builds	VBZ	build
build	VBP	build
built	VBD	build
built	VBN	build
bulging	VBG	bulge
bulkheads	NNS	bulkhead
bulldozed	VBN	bulldoze
bulletins	NNS	bulletin
bullied	VBD	bully
bullies	VBZ	bully
bumbling	VBG	bumble
bumped	VBD	bump
bumped	VBN	bump
bundled	VBN	bundle
bundles	NNS	bundle
bungled	VBN	bungle
buoyed	VBD	buoy
buoyed	VBN	buoy
buoying	VBG	buoy
buoys	VBZ	buoy
burbles	NNS	burble
burdened	VBD	burden
burdened	VBN	burden
burdens	NNS	burden
bureaucracies	NNS	bureaucracy
bureaucrats	NNS	bureaucrat
bureaus	NNS	bureau
burgeoning	VBG	burgeon
burglaries	NNS	burglary
burglarized	VBN	burglarize
buried	VBD	bury
buried	VBN	bury
burned	VBD	burn
burned	VBN	burn
burning	VBG	burn
burnishing	VBG	burnish
burns	NNS	burns
burns	VBZ	burn
bursting	VBG	burst
bursts	NNS	burst
burst	VBD	burst
burying	VBG	bury
bury	VBP	bury
bushels	NNS	bushel
businesses	NNS	business
busted	VBN	bust
busting	VBG	bust
buttressed	VBD	buttress
buttressed	VBN	buttress
buttresses	VBZ	buttress
buyers	NNS	buyer
buying	VBG	buy
buyouts	NNS	buyout
buys	NNS	buy
buys	VBZ	buy
buy	VBP	buy
buzzes	VBZ	buzz
buzzing	VBG	buzz
bylines	NNS	bylines
cabinets	NNS	cabinet
caches	NNS	cache
cadge	VBP	cadge
caked	VBD	cake
calculated	VBN	calculate
calculates	VBZ	calculate
calculating	VBG	calculate
calculations	NNS	calculation
calibrated	VBN	calibrate
called	NNP	call
called	VBD	call
called	VBN	call
callers	NNS	caller
calling	VBG	call
call	NNP	call
calls	NNS	call
calls	VBZ	call
call	VBP	call
calmed	VBN	calm
calming	VBG	calm
came	VBD	come
camouflaged	VBN	camouflage
campaigned	VBN	campaign
campaigns	NNS	campaign
camps	NNS	camp
campuses	NNS	campus
canceled	VBD	cancel
canceled	VBN	cancel
cancellations	NNS	cancellation
cancels	NNS	cancel
cancers	NNS	cancer
candidates	NNS	candidate
cans	NNS	can
canvassed	VBN	canvass
capabilities	NNS	capability
capitalists	NNS	capitalist
capitalized	VBN	capitalize
capitalizing	VBG	capitalize
capitulated	VBN	capitulate
capped	VBD	cap
capped	VBN	cap
capping	VBG	cap
caps	NNS	cap
capsules	NNS	capsule
captivating	VBG	captivate
captives	NNS	captive
captured	VBN	capture
capturing	VBG	capture
cared	VBD	care
careened	VBD	careen
careening	VBG	careen
careers	NNS	career
care	NNP	care
cares	VBZ	care
care	VBP	care
caring	VBG	care
carried	VBD	carry
carried	VBN	carry
carriers	NNS	carrier
carries	VBZ	carry
carryforwards	NNS	carryforwards
carrying	VBG	carry
carry	VBP	carry
carted	VBD	cart
carting	VBG	cart
cartoons	NNS	cartoon
carved	VBN	carve
carves	VBZ	carve
carve	VBP	carve
carving	VBG	carve
caseloads	NNS	caseloads
case	NNP	case
cases	NNS	case
cashed	VBN	cash
cashing	VBG	cash
castigated	VBN	castigate
castigating	VBG	castigate
casting	VBG	cast
casts	VBZ	cast
cast	VBD	cast
cast	VBN	cast
casualties	NNS	casualty
cataloging	VBG	catalog
catapult	VBP	catapult
catching	VBG	catch
catch	VBP	catch
categories	NNS	category
categorized	VBN	categorize
catered	VBD	cater
catering	VBG	cater
caters	NNS	cater
cater	VBP	cater
caught	VBD	catch
caught	VBN	catch
caused	VBD	cause
caused	VBN	cause
causes	NNS	cause
causes	VBZ	cause
cause	VBP	cause
causing	VBG	cause
cautioned	VBD	caution
cautioning	VBG	caution
cautions	VBZ	caution
caution	VBP	caution
caved	VBD	cave
ceased	VBD	cease
ceases	VBZ	cease
ceded	VBD	cede
ceded	VBN	cede
ceding	VBG	cede
ceilings	NNS	ceiling
celebrated	VBD	celebrate
celebrates	VBZ	celebrate
celebrating	VBG	celebrate
celebrations	NNS	celebration
cementing	VBG	cement
censored	VBN	censor
censor	VBP	censor
centered	VBD	center
centered	VBN	center
centering	VBG	center
center	NNP	center
centers	NNS	center
centers	VBZ	center
cents	NNS	cent
centuries	NNS	century
certificates	NNP	certificate
certificates	NNS	certificate
certified	VBN	certify
chafed	VBN	chafe
chafe	VBP	chafe
chains	NNS	chains
chaired	VBN	chair
chairmen	NNS	chairman
chairs	VBZ	chair
chalked	VBN	chalk
challenged	VBD	challenge
challenged	VBN	challenge
challengers	NNS	challenger
challenges	NNS	challenge
challenges	VBZ	challenge
challenge	VBP	challenge
challenging	VBG	challenge
chambers	NNS	chambers
championed	VBN	champion
championships	NNS	championship
champions	NNS	champion
champs	NNS	champ
chances	NNS	chance
changed	VBD	change
changed	VBN	change
changes	NNS	change
changes	VBZ	change
change	VBP	change
changing	VBG	change
channeled	VBD	channel
channels	NNS	channels
chanted	VBD	chant
chanting	VBG	chant
chapters	NNS	chapter
characteristics	NNS	characteristic
characterized	VBD	characterize
characterized	VBN	characterize
characterizes	VBZ	characterize
characters	NNS	character
charged	VBD	charge
charged	VBN	charge
charges	NNS	charge
charges	VBZ	charge
charge	VBP	charge
charging	VBG	charge
charred	VBN	char
chartered	VBD	charter
chartered	VBN	charter
charts	NNS	chart
chased	VBD	chase
chasers	NNS	chaser
chasing	VBG	chase
chastises	VBZ	chastise
chatting	VBG	chat
cheapens	VBZ	cheapen
cheated	VBD	cheat
cheaters	NNS	cheater
cheating	VBG	cheat
checked	VBN	check
checking	VBG	check
checks	NNS	check
check	VBP	check
cheered	VBD	cheer
cheered	VBN	cheer
cheering	VBG	cheer
cheers	NNS	cheer
chefs	NNS	chef
chemicals	NNS	chemical
chemists	NNS	chemist
cherished	VBN	cherish
chewed	VBN	chew
chewing	VBG	chew
chew	VBP	chew
chided	VBD	chide
chided	VBN	chide
chides	VBZ	chide
chiefs	NNS	chief
children	NNP	child
children	NNS	child
chimes	VBZ	chime
chipped	VBN	chip
chipping	VBG	chip
chips	NNS	chip
choices	NNS	choice
choked	VBD	choke
choked	VBN	choke
choking	VBG	choke
chooses	VBZ	choose
choose	VBP	choose
choosing	VBG	choose
chopping	VBG	chop
chores	NNS	chore
chortled	VBD	chortle
chosen	VBN	choose
chose	VBD	choose
chronicles	NNS	chronicle
chronicles	VBZ	chronicle
chucked	VBD	chuck
chuckles	NNS	chuckle
chuckling	VBG	chuckle
chunks	NNS	chunk
churn	VBP	churn
circled	VBD	circle
circles	NNS	circle
circuited	VBN	circuit
circuits	NNS	circuit
circulated	VBD	circulate
circulated	VBN	circulate
circulate	VBP	circulate
circulating	VBG	circulate
circumstances	NNS	circumstances
circumventing	VBG	circumvent
citations	NNS	citation
cited	VBD	cite
cited	VBN	cite
cites	VBZ	cite
cite	VBP	cite
cities	NNS	city
citing	VBG	cite
citizens	NNS	citizen
claimants	NNS	claimant
claimed	VBD	claim
claimed	VBN	claim
claiming	VBG	claim
claims	NNP	claim
claims	NNS	claim
claims	VBZ	claim
claim	VBP	claim
clambered	VBD	clamber
clampdowns	NNS	clampdown
clamping	VBG	clamp
clanging	VBG	clang
clanking	VBG	clank
clarifications	NNS	clarification
clarified	VBN	clarify
clarifies	VBZ	clarify
clarifying	VBG	clarify
clashed	VBN	clash
clashes	NNS	clash
classes	NNS	class
classifications	NNS	classification
classified	VBN	classify
classifies	VBZ	classify
classmates	NNS	classmate
class	NNP	class
clause	NNP	clause
clauses	NNS	clause
cleaned	VBD	clean
cleaned	VBN	clean
cleaners	NNS	cleaners
cleaning	VBG	clean
cleansers	NNS	cleanser
cleans	VBZ	clean
clearances	NNS	clearance
cleared	VBD	clear
cleared	VBN	clear
clearing	VBG	clear
clears	VBZ	clear
clients	NNS	client
climbed	VBD	climb
climbed	VBN	climb
climbers	NNS	climber
climbing	VBG	climb
climbs	VBZ	climb
clinched	VBD	clinch
cling	VBP	cling
clipped	VBD	clip
clippings	NNS	clipping
clips	NNS	clip
cloak	VBP	cloak
clobbered	VBN	clobber
clocks	NNS	clock
clogged	VBN	clog
cloned	VBN	clone
clones	NNS	clone
closed	VBD	close
closed	VBN	close
closes	NNS	close
closes	VBZ	close
close	VBP	close
closings	NNS	closing
closing	VBG	close
clothed	VBN	clothe
clouded	VBN	cloud
clouds	NNS	cloud
clubbed	VBD	club
clubs	NNS	club
clues	NNS	clue
clustered	VBN	cluster
clusters	NNS	cluster
clutching	VBG	clutch
clutch	VBP	clutch
coasted	VBD	coast
coated	VBN	coat
coatings	NNS	coating
coattails	NNS	coattail
cobbled	VBD	cobble
coddled	VBN	coddle
coded	VBN	code
codes	NNS	code
codifying	VBG	codify
coerces	VBZ	coerce
cohorts	NNS	cohort
coincided	VBD	coincide
coincides	VBZ	coincide
coined	VBN	coin
collaborated	VBD	collaborate
collaborate	VBP	collaborate
collaborating	VBG	collaborate
collages	NNS	collage
collapsed	VBD	collapse
collapsed	VBN	collapse
collapse	NNP	collapse
collapses	NNS	collapse
collapses	VBZ	collapse
collapsing	VBG	collapse
colleagues	NNS	colleague
collected	VBD	collect
collected	VBN	collect
collecting	VBG	collect
collections	NNS	collection
collectors	NNS	collector
collects	VBZ	collect
collect	VBP	collect
colonies	NNS	colony
colored	VBN	color
colors	NNS	colors
columnists	NNS	columnist
columns	NNS	column
combating	VBG	combat
combatting	VBG	combat
combed	VBN	comb
combined	VBD	combine
combined	VBN	combine
combines	VBZ	combine
combine	VBP	combine
combing	VBG	comb
combining	VBG	combine
comedies	NNS	comedy
comes	VBZ	come
come	VBD	come
come	VBN	come
come	VBP	come
comforted	VBN	comfort
comfort	NNP	comfort
coming	VBG	come
commanders	NNS	commander
commanding	VBG	command
commandos	NNS	commando
commemorated	VBD	commemorate
commenced	VBN	commence
commencing	VBG	commence
commends	VBZ	commend
commentaries	NNS	commentary
commentators	NNS	commentator
commented	VBD	comment
commenting	VBG	comment
comment	NNP	comment
comments	NNS	comment
commercializing	VBG	commercialize
commercials	NNS	commercial
commissioned	VBD	commission
commissioned	VBN	commission
commissioners	NNS	commissioner
commissioning	VBG	commission
commissions	NNS	commission
commitments	NNS	commitment
commits	VBZ	commit
committed	VBD	commit
committed	VBN	commit
committee	NNP	committee
committees	NNS	committee
committing	VBG	commit
commit	VBP	commit
communicated	VBN	communicate
communications	NNS	communications
communiques	NNS	communique
communities	NNS	community
commuters	NNS	commuter
commutes	NNS	commute
commuting	VBG	commute
compacted	VBN	compact
companions	NNS	companion
compared	VBD	compare
compared	VBN	compare
compare	NNP	compare
compares	VBZ	compare
compare	VBP	compare
comparing	VBG	compare
comparisons	NNS	comparison
compatriots	NNS	compatriot
compelled	VBN	compel
compensated	VBN	compensate
compensates	VBZ	compensate
compensations	NNS	compensation
competed	VBN	compete
competes	VBZ	compete
compete	VBP	compete
competing	VBG	compete
competitors	NNS	competitor
compiled	VBN	compile
compiling	VBG	compile
complained	VBD	complain
complained	VBN	complain
complaining	VBG	complain
complains	VBZ	complain
complaints	NNS	complaint
complain	VBP	complain
complements	VBZ	complement
completed	VBD	complete
completed	VBN	complete
completes	VBZ	complete
completing	VBG	complete
complexes	NNS	complex
complexities	NNS	complexity
complicated	VBD	complicate
complicated	VBN	complicate
complicates	VBZ	complicate
complications	NNS	complication
complied	VBN	comply
compliments	NNS	compliments
complying	VBG	comply
components	NNS	component
composed	VBN	compose
composers	NNS	composer
compositions	NNS	composition
compounded	VBD	compound
compounded	VBN	compound
compounding	VBG	compound
compressed	VBN	compress
comprised	VBN	comprise
comprises	VBZ	comprise
comprise	VBP	comprise
comprising	VBG	comprise
compromised	VBN	compromise
compromises	NNS	compromise
compromising	VBG	compromise
comptroller	NNP	comptroller
compulsions	NNS	compulsion
computerizing	VBG	computerize
computers	NNS	computer
computes	VBZ	compute
computing	VBG	compute
comrades	NNS	comrade
concealed	VBN	conceal
concealing	VBG	conceal
conceded	VBD	concede
conceded	VBN	concede
concedes	VBZ	concede
concede	VBP	concede
conceding	VBG	concede
conceived	VBN	conceive
conceiving	VBG	conceive
concentrated	VBD	concentrate
concentrated	VBN	concentrate
concentrates	VBZ	concentrate
concentrate	VBP	concentrate
concentrating	VBG	concentrate
concentrations	NNS	concentration
conceptions	NNS	conception
concepts	NNS	concept
concerned	VBD	concern
concerned	VBN	concern
concerning	VBG	concern
concerns	NNS	concern
concerns	VBZ	concern
concerts	NNS	concert
concessions	NNS	concession
concluded	VBD	conclude
concluded	VBN	conclude
concludes	VBZ	conclude
conclude	VBP	conclude
concluding	VBG	conclude
conclusions	NNS	conclusion
concocted	VBN	concoct
concoctions	NNS	concoction
concocts	VBZ	concoct
concurred	VBD	concur
condemned	VBD	condemn
condemned	VBN	condemn
condemning	VBG	condemn
condemns	VBZ	condemn
conditioned	VBN	condition
conditioners	NNS	conditioner
conditions	NNS	condition
condoned	VBD	condone
conducted	VBD	conduct
conducted	VBN	conduct
conducting	VBG	conduct
conducts	VBZ	conduct
conduct	VBP	conduct
conduits	NNS	conduit
conferees	NNS	conferee
conferences	NNS	conference
conferred	VBD	confer
conferring	VBG	confer
confers	VBZ	confer
confessed	VBD	confess
confessed	VBN	confess
confesses	VBZ	confess
confessing	VBG	confess
confessions	NNS	confession
confidants	NNS	confidant
confided	VBD	confide
confides	VBZ	confide
confiding	VBG	confide
confined	VBN	confine
confirmed	VBD	confirm
confirmed	VBN	confirm
confirming	VBG	confirm
confirms	VBZ	confirm
confirm	VBP	confirm
confiscated	VBD	confiscate
confiscated	VBN	confiscate
confiscating	VBG	confiscate
conflicts	NNS	conflict
conforming	VBG	conform
confrontations	NNS	confrontation
confronted	VBN	confront
confronting	VBG	confront
confronts	VBZ	confront
confront	VBP	confront
confused	VBN	confuse
confusing	VBG	confuse
congratulated	VBD	congratulate
congratulated	VBN	congratulate
congressmen	NNS	congressman
conjures	VBZ	conjure
connected	VBN	connect
connecting	VBG	connect
connections	NNS	connection
connects	VBZ	connect
connect	VBP	connect
consented	VBD	consent
consenting	VBG	consent
consents	NNS	consent
consequences	NNS	consequence
considerations	NNS	consideration
considered	VBD	consider
considered	VBN	consider
considering	VBG	consider
considers	VBZ	consider
consider	VBP	consider
consigns	VBZ	consign
consisted	VBD	consist
consisting	VBG	consist
consists	VBZ	consist
consist	VBP	consist
consoles	VBZ	console
consolidated	VBN	consolidate
consolidates	VBZ	consolidate
consolidating	VBG	consolidate
consolidations	NNS	consolidation
consorting	VBG	consort
conspiracies	NNS	conspiracy
conspired	VBD	conspire
conspiring	VBG	conspire
constituencies	NNS	constituency
constituents	NNS	constituent
constituted	VBD	constitute
constitutes	VBZ	constitute
constitute	VBP	constitute
constrained	VBN	constrain
constrains	VBZ	constrain
constraints	NNS	constraint
constricting	VBG	constrict
constructed	VBN	construct
constructing	VBG	construct
construed	VBN	construe
consultant	NNP	consultant
consultants	NNS	consultant
consulted	VBN	consult
consulting	VBG	consult
consumed	VBN	consume
consumers	NNS	consumer
consume	VBP	consume
consuming	VBG	consume
consummated	VBN	consummate
contacted	VBN	contact
contacting	VBG	contact
contacts	NNS	contact
contained	VBD	contain
contained	VBN	contain
containers	NNS	container
containing	VBG	contain
contains	VBZ	contain
contain	VBP	contain
contaminated	VBD	contaminate
contaminated	VBN	contaminate
contemplated	VBN	contemplate
contemplates	VBZ	contemplate
contemplating	VBG	contemplate
contemporaries	NNS	contemporaries
contended	VBD	contend
contended	VBN	contend
contending	VBG	contend
contends	VBZ	contend
contend	VBP	contend
contentions	NNS	contention
contents	NNS	contents
contested	VBN	contest
contesting	VBG	contest
continued	VBD	continue
continued	VBN	continue
continues	VBZ	continue
continue	VBP	continue
continuing	VBG	continue
contracted	VBD	contract
contracted	VBN	contract
contracting	VBG	contract
contractions	NNS	contraction
contractors	NNS	contractor
contracts	NNS	contract
contradicting	VBG	contradict
contradicts	VBZ	contradict
contrasted	VBD	contrast
contrasting	VBG	contrast
contrasts	VBZ	contrast
contravened	VBN	contravene
contributed	VBD	contribute
contributed	VBN	contribute
contributes	VBZ	contribute
contribute	VBP	contribute
contributing	VBG	contribute
contributions	NNS	contribution
contributors	NNS	contributor
controlled	VBD	control
controlled	VBN	control
controllers	NNS	controller
controlling	VBG	control
control	NNP	control
controls	NNS	control
controls	VBZ	control
control	VBP	control
controversies	NNS	controversy
convened	VBD	convene
convened	VBN	convene
convenes	VBZ	convene
convening	VBG	convene
convention	NNP	convention
converged	VBD	converge
conversations	NNS	conversation
conversions	NNS	conversion
converted	VBD	convert
converted	VBN	convert
converters	NNS	converter
converting	VBG	convert
converts	VBZ	convert
convert	VBP	convert
conveyed	VBD	convey
conveys	NNS	convey
convicted	VBD	convict
convicted	VBN	convict
convictions	NNS	conviction
convinced	VBN	convince
convinces	VBZ	convince
convincing	VBG	convince
convoys	NNS	convoy
convulsions	NNS	convulsion
cooked	VBN	cook
cooking	VBG	cook
cooled	VBD	cool
cooled	VBN	cool
cooling	VBG	cool
cools	NNS	cool
cooperated	VBD	cooperate
cooperating	VBG	cooperate
coordinated	VBN	coordinate
coordinates	VBZ	coordinate
coordinating	VBG	coordinate
copied	VBN	copy
copies	NNS	copy
coping	VBG	cope
copying	VBG	copy
copy	NNP	copy
copyrighted	VBN	copyright
copyright	NNP	copyright
copyrights	NNS	copyright
cornered	VBN	corner
corners	NNS	corner
corrected	VBN	correct
correcting	VBG	correct
corrects	VBZ	correct
corresponded	VBN	correspond
correspondents	NNS	correspondent
corresponding	VBG	correspond
corroborate	VBP	corroborate
costing	VBG	cost
costs	NNS	costs
costs	VBZ	cost
costumed	VBN	costume
cost	VBD	cost
cost	VBN	cost
cost	VBP	cost
couched	VBN	couch
couching	VBG	couch
coughed	VBD	cough
coughed	VBN	cough
coughing	VBG	cough
councils	NNS	council
counseled	VBN	counsel
counseling	VBG	counsel
counselors	NNS	counselor
counsels	VBZ	counsel
counted	VBD	count
counted	VBN	count
counteracted	VBN	counteract
counterbidders	NNS	counterbidders
countered	VBD	counter
countering	VBG	counter
counterparts	NNS	counterpart
counters	NNS	counter
countervailing	VBG	countervail
counter	VBP	counter
counties	NNS	county
counting	VBG	count
countries	NNS	country
countrymen	NNS	countryman
counts	NNS	count
counts	VBZ	count
coupled	VBN	couple
coupons	NNS	coupon
coups	NNS	coup
coursed	VBD	course
courses	NNS	course
courted	VBN	court
courtesies	NNS	courtesy
courting	VBG	court
courts	NNS	court
cousins	NNS	cousin
covenants	NNS	covenant
coverages	NNS	coverage
covered	VBD	cover
covered	VBN	cover
covering	VBG	cover
covers	NNS	cover
covers	VBZ	cover
coverts	NNS	covert
cover	VBP	cover
covets	VBZ	covet
cower	VBP	cower
cracked	VBD	crack
cracked	VBN	crack
cracking	VBG	crack
cracks	NNS	crack
crafted	VBN	craft
crafting	VBG	craft
crammed	VBD	cram
cramming	VBG	cram
crams	VBZ	cram
craning	VBG	crane
crashed	VBD	crash
crashes	NNS	crash
crashes	VBZ	crash
crashing	VBG	crash
crawled	VBD	crawl
crawling	VBG	crawl
crawls	VBZ	crawl
created	VBD	create
created	VBN	create
creates	VBZ	create
create	VBP	create
creating	VBG	create
creations	NNS	creation
creators	NNS	creator
credentials	NNS	credentials
credited	VBD	credit
credited	VBN	credit
creditors	NNS	creditor
credits	NNS	credits
creeping	VBG	creep
crept	VBD	creep
crept	VBN	creep
crews	NNS	crew
cries	VBZ	cry
crimes	NNS	crime
criminals	NNS	criminal
crimping	VBG	crimp
cringed	VBD	cringe
crippled	VBN	cripple
crises	NNS	crisis
crisscrossing	VBG	crisscross
criteria	NNS	criterion
criticisms	NNS	criticism
criticized	VBD	criticize
criticized	VBN	criticize
criticizes	VBZ	criticize
criticize	VBP	criticize
criticizing	VBG	criticize
critics	NNS	critic
cronies	NNS	crony
crooks	NNS	crook
crooned	VBD	croon
croons	VBZ	croon
cropped	VBD	crop
cropping	VBG	crop
crops	NNS	crop
crossed	VBD	cross
crossed	VBN	cross
crosses	VBZ	cross
crossing	VBG	cross
cross	VBP	cross
crouched	VBD	crouch
crouched	VBN	crouch
crowded	VBD	crowd
crowded	VBN	crowd
crowds	NNS	crowd
crowed	VBN	crow
crows	VBZ	crow
cruising	VBG	cruise
crumbled	VBD	crumble
crumbled	VBN	crumble
crumbles	NNS	crumble
crumbling	VBG	crumble
crumpled	VBN	crumple
crunched	VBD	crunch
crushed	VBN	crush
crushes	VBZ	crush
crushing	VBG	crush
cryptographers	NNS	cryptographer
cues	NNS	cue
culminated	VBN	culminate
culminates	VBZ	culminate
culminating	VBG	culminate
culprits	NNS	culprit
cultivated	VBN	cultivate
cultivates	VBZ	cultivate
cultivating	VBG	cultivate
cultures	NNS	culture
curators	NNS	curator
curbed	VBN	curb
curbing	VBG	curb
curbs	NNS	curb
curled	VBN	curl
currents	NNS	current
cursed	VBD	curse
curtailed	VBN	curtail
curtailing	VBG	curtail
cushioned	VBN	cushion
customers	NNS	customer
customized	VBN	customize
customs	NNS	customs
cutbacks	NNS	cutback
cutouts	NNS	cutout
cuts	NNS	cut
cuts	VBZ	cut
cutters	NNS	cutter
cutting	VBG	cut
cut	VBD	cut
cut	VBN	cut
cut	VBP	cut
cycles	NNS	cycle
dabbled	VBD	dabble
dabbling	VBG	dabble
dabs	VBZ	dab
dalliances	NNS	dalliance
damaged	VBD	damage
damaged	VBN	damage
damages	NNS	damages
damaging	VBG	damage
damped	VBP	damp
dampened	VBD	dampen
damping	VBG	damp
dancers	NNS	dancer
dancing	VBG	dance
dangers	NNS	danger
dangled	VBN	dangle
dangling	VBG	dangle
dared	VBD	dare
dashed	VBD	dash
dashed	VBN	dash
dated	VBN	date
dates	NNS	date
dates	VBZ	date
date	VBP	date
dating	VBG	date
daughters	NNS	daughter
daunting	VBG	daunt
dawdling	VBG	dawdle
dawning	VBG	dawn
dawns	VBZ	dawn
day	NNP	day
days	NNS	days
dazzled	VBN	dazzle
deactivates	VBZ	deactivate
deadlines	NNS	deadline
dealerships	NNS	dealership
dealers	NNS	dealer
dealings	NNS	dealings
dealing	VBG	deal
deals	NNS	deal
dealt	VBD	deal
dealt	VBN	deal
deal	VBP	deal
deaths	NNS	death
debacles	NNS	debacle
debates	NNS	debate
debating	VBG	debate
debentures	NNS	debenture
debt	NNP	debt
debtors	NNS	debtor
debts	NNS	debt
decades	NNS	decade
deceased	VBN	decease
deceived	VBD	deceive
decelerated	VBN	decelerate
decelerating	VBG	decelerate
decentralized	VBN	decentralize
decentralizing	VBG	decentralize
decided	VBD	decide
decided	VBN	decide
decides	VBZ	decide
decide	VBP	decide
deciding	VBG	decide
decimated	VBN	decimate
decisions	NNS	decision
decked	VBD	deck
decks	NNS	deck
declarations	NNS	declaration
declared	VBD	declare
declared	VBN	declare
declares	VBZ	declare
declaring	VBG	declare
declassifying	VBG	declassify
declined	VBD	decline
declined	VBN	decline
decliners	NNS	decliners
declines	NNS	decline
declines	VBZ	decline
decline	VBP	decline
declining	VBG	decline
decontaminated	VBN	decontaminate
decorated	VBN	decorate
decreased	VBD	decrease
decreased	VBN	decrease
decreases	NNS	decrease
decreasing	VBG	decrease
decreed	VBN	decree
decries	VBZ	decry
dedicated	VBD	dedicate
dedicated	VBN	dedicate
deducting	VBG	deduct
deemed	VBD	deem
deemed	VBN	deem
deems	VBZ	deem
deem	VBP	deem
deepened	VBD	deepen
deepening	VBG	deepen
defaulted	VBD	default
defaulted	VBN	default
defaulting	VBG	default
defaults	NNS	default
defeated	VBD	defeat
defeated	VBN	defeat
defeating	VBG	defeat
defeats	VBZ	defeat
defected	VBD	defect
defecting	VBG	defect
defections	NNS	defection
defect	NNP	defect
defects	NNS	defect
defendants	NNS	defendant
defended	VBD	defend
defended	VBN	defend
defenders	NNS	defender
defending	VBG	defend
defends	VBZ	defend
defend	VBP	defend
defenses	NNS	defense
deferred	VBN	defer
deferring	VBG	defer
deficiencies	NNS	deficiency
deficits	NNS	deficit
defied	VBD	defy
defined	VBD	define
defined	VBN	define
defines	VBZ	define
defining	VBG	define
definitions	NNS	definition
deflated	VBN	deflate
deflators	NNS	deflator
deflecting	VBG	deflect
deformed	VBN	deform
defrauded	VBD	defraud
defrauded	VBN	defraud
defrauding	VBG	defraud
defying	VBG	defy
defy	VBP	defy
degenerated	VBD	degenerate
degenerated	VBN	degenerate
degrees	NNS	degree
delayed	VBD	delay
delayed	VBN	delay
delaying	VBG	delay
delays	NNS	delay
delay	VBP	delay
delegates	NNS	delegate
delegating	VBG	delegate
deleted	VBD	delete
deleted	VBN	delete
deleting	VBG	delete
deletions	NNS	deletion
deliberations	NNS	deliberation
delighted	VBN	delight
delights	VBZ	delight
delinquencies	NNS	delinquency
delinquents	NNS	delinquent
delivered	VBD	deliver
delivered	VBN	deliver
deliveries	NNS	delivery
delivering	VBG	deliver
delivers	VBZ	deliver
deliver	VBP	deliver
delousing	VBG	delouse
delved	VBN	delve
delves	VBZ	delve
demanded	VBD	demand
demanded	VBN	demand
demanding	VBG	demand
demands	NNS	demand
demands	VBZ	demand
demand	VBP	demand
demeanors	NNS	demeanor
demobilizing	VBG	demobilize
democratized	VBN	democratize
demographics	NNS	demographic
demolished	VBN	demolish
demolishing	VBG	demolish
demonized	VBN	demonize
demonstrated	VBD	demonstrate
demonstrated	VBN	demonstrate
demonstrates	VBZ	demonstrate
demonstrating	VBG	demonstrate
demonstrations	NNS	demonstration
demonstrators	NNS	demonstrator
demoted	VBN	demote
demurs	VBZ	demur
denied	VBD	deny
denied	VBN	deny
denies	VBZ	deny
denizens	NNS	denizen
de	NNP	deemphasize
denominated	VBN	denominate
denominations	NNS	denomination
denounced	VBD	denounce
denounced	VBN	denounce
denounce	VBP	denounce
denouncing	VBG	denounce
dents	NNS	dent
denying	VBG	deny
deny	VBP	deny
departed	VBD	depart
departing	VBG	depart
departments	NNS	department
departures	NNS	departure
depart	VBP	depart
depended	VBD	depend
depended	VBN	depend
dependents	NNS	dependent
depending	VBG	depend
depends	VBZ	depend
depend	VBP	depend
depicted	VBN	depict
depicting	VBG	depict
depicts	VBZ	depict
depict	VBP	depict
depleted	VBN	deplete
depletes	VBZ	deplete
deplores	VBZ	deplore
deploring	VBG	deplore
deployed	VBN	deploy
deported	VBD	deport
deposed	VBN	depose
deposited	VBD	deposit
depositing	VBG	deposit
depositions	NNS	deposition
depositors	NNS	depositor
deposits	NNS	deposit
depressed	VBD	depress
depressed	VBN	depress
depresses	VBZ	depress
depressing	VBG	depress
depress	VBP	depress
deprived	VBD	deprive
deprived	VBN	deprive
deprives	VBZ	deprive
depriving	VBG	deprive
depths	NNS	depth
deputies	NNPS	deputy
deputies	NNS	deputy
derailed	VBN	derail
derailing	VBG	derail
deregulated	VBN	deregulate
derided	VBD	deride
derivatives	NNS	derivative
derived	VBN	derive
derives	VBZ	derive
deriving	VBG	derive
descended	VBN	descend
descending	VBG	descend
descends	VBZ	descend
described	VBD	describe
described	VBN	describe
describes	VBZ	describe
describe	VBP	describe
describing	VBG	describe
descriptions	NNS	description
deserted	VBN	desert
deserved	VBD	deserve
deserves	VBZ	deserve
deserve	VBP	deserve
designated	VBN	designate
designating	VBG	designate
designed	VBD	design
designed	VBN	design
designees	NNS	designees
designers	NNS	designer
designing	VBG	design
designs	NNS	design
designs	VBZ	design
desired	VBN	desire
despairs	VBZ	despair
destabilizing	VBG	destabilize
destinations	NNS	destination
destined	VBN	destine
destroyed	VBD	destroy
destroyed	VBN	destroy
destroying	VBG	destroy
destroys	VBZ	destroy
destructed	VBN	destruct
detached	VBN	detach
detailed	VBN	detail
detailing	VBG	detail
details	NNS	details
detained	VBD	detain
detained	VBN	detain
detaining	VBG	detain
detected	VBD	detect
detected	VBN	detect
detecting	VBG	detect
detectors	NNS	detector
detect	VBP	detect
deteriorated	VBD	deteriorate
deteriorated	VBN	deteriorate
deteriorates	VBZ	deteriorate
deteriorate	VBP	deteriorate
deteriorating	VBG	deteriorate
determined	VBD	determine
determined	VBN	determine
determines	VBZ	determine
determine	VBP	determine
determining	VBG	determine
deterred	VBN	deter
deterring	VBG	deter
deters	VBZ	deter
detests	VBZ	detest
dethroned	VBN	dethrone
detractors	NNS	detractor
detracts	VBZ	detract
devaluations	NNS	devaluation
devalued	VBD	devalue
devalued	VBN	devalue
devastated	VBD	devastate
devastated	VBN	devastate
devastating	VBG	devastate
developed	VBD	develop
developed	VBN	develop
developers	NNS	developer
developing	VBG	develop
developments	NNS	development
develops	VBZ	develop
develop	VBP	develop
deviated	VBD	deviate
devices	NNS	devices
devised	VBD	devise
devised	VBN	devise
devises	VBZ	devise
devoted	VBN	devote
devotes	VBZ	devote
devote	VBP	devote
devoured	VBN	devour
diagnosed	VBD	diagnose
diagnosed	VBN	diagnose
diagnosing	VBG	diagnose
diagramming	VBG	diagram
dialing	VBG	dial
diaries	NNS	diary
dictated	VBD	dictate
dictated	VBN	dictate
dictates	NNS	dictate
dictates	VBZ	dictate
dictatorships	NNS	dictatorship
dictators	NNS	dictator
did	VBD	do
died	VBD	die
died	VBN	die
dies	NNS	die
dies	VBZ	die
die	VBP	die
differences	NNS	difference
differentials	NNS	differential
differentiating	VBG	differentiate
differing	VBG	differ
differs	VBZ	differ
differ	VBP	differ
difficulties	NNS	difficulty
digesting	VBG	digest
dignitaries	NNS	dignitary
digs	NNS	digs
digs	VBZ	dig
diluted	VBD	dilute
diluted	VBN	dilute
diluting	VBG	dilute
dimensions	NNS	dimension
diminished	VBN	diminish
diminishes	NNS	diminish
diminishing	VBG	diminish
dined	VBN	dine
diplomats	NNS	diplomat
dipped	VBD	dip
dipping	VBG	dip
dips	NNS	dip
directed	VBD	direct
directed	VBN	direct
directing	VBG	direct
directions	NNS	direction
directives	NNS	directive
directories	NNS	directory
directors	NNS	director
directs	VBZ	direct
disabilities	NNS	disability
disabled	VBN	disable
disabling	VBG	disable
disadvantages	NNS	disadvantage
disagreed	VBD	disagree
disagreed	VBN	disagree
disagrees	VBZ	disagree
disagree	VBP	disagree
disallowed	VBD	disallow
disappeared	VBD	disappear
disappears	VBZ	disappear
disappointed	VBD	disappoint
disappointed	VBN	disappoint
disappointments	NNS	disappointment
disapproved	VBN	disapprove
disapproves	VBZ	disapprove
disarming	VBG	disarm
disasters	NNS	disaster
disavowed	VBD	disavow
disbanded	VBN	disband
disbanding	VBG	disband
disbursed	VBN	disburse
disbursements	NNS	disbursement
discarded	VBD	discard
discarded	VBN	discard
discharged	VBN	discharge
discharges	NNS	discharge
disciplined	VBN	discipline
disciplining	VBG	discipline
disclaims	VBZ	disclaim
disclosed	VBD	disclose
disclosed	VBN	disclose
discloses	VBZ	disclose
disclosing	VBG	disclose
disclosures	NNS	disclosure
discolored	VBN	discolor
disconnected	VBN	disconnect
discontinued	VBN	discontinue
discontinuing	VBG	discontinue
discounted	VBD	discount
discounted	VBN	discount
discounting	VBG	discount
discounts	NNS	discount
discouraged	VBN	discourage
discourages	VBZ	discourage
discourage	VBP	discourage
discouraging	VBG	discourage
discovered	VBD	discover
discovered	VBN	discover
discovering	VBG	discover
discovers	NNS	discover
discover	VBP	discover
discredited	VBN	discredit
discrepancies	NNS	discrepancy
discriminating	VBG	discriminate
discussed	VBD	discuss
discussed	VBN	discuss
discussing	VBG	discuss
discussions	NNS	discussion
disdaining	VBG	disdain
diseases	NNS	disease
disenchanted	VBN	disenchant
disgruntled	VBN	disgruntle
disguised	VBN	disguise
disgusted	VBN	disgust
disinclined	VBN	disincline
disintegrated	VBN	disintegrate
disintegrating	VBG	disintegrate
dislikes	VBZ	dislike
dislike	VBP	dislike
dislocations	NNS	dislocation
dismantled	VBN	dismantle
dismantle	NNP	dismantle
dismantling	VBG	dismantle
dismayed	VBN	dismay
dismissed	VBD	dismiss
dismissed	VBN	dismiss
dismisses	VBZ	dismiss
dismissing	VBG	dismiss
disorders	NNS	disorder
disparaging	VBG	disparage
disparities	NNS	disparity
dispatched	VBD	dispatch
dispatched	VBN	dispatch
dispatchers	NNS	dispatcher
dispatching	VBG	dispatch
dispelled	VBD	dispel
dispensed	VBD	dispense
dispense	VBP	dispense
dispensing	VBG	dispense
dispersed	VBD	disperse
dispersing	VBG	disperse
displaced	VBN	displace
displayed	VBD	display
displayed	VBN	display
displaying	VBG	display
displays	NNS	display
display	VBP	display
displeases	VBZ	displease
disposals	NNS	disposal
disposed	VBN	dispose
disposes	NNS	dispose
disposing	VBG	dispose
disputed	VBD	dispute
disputed	VBN	dispute
dispute	NNP	dispute
disputes	NNS	dispute
disputes	VBZ	dispute
disqualified	VBN	disqualify
disregarded	VBD	disregard
disrupted	VBD	disrupt
disrupted	VBN	disrupt
disrupting	VBG	disrupt
disruptions	NNS	disruption
dissatisfied	VBN	dissatisfy
dissected	VBN	dissect
dissecting	VBG	dissect
disseminated	VBN	disseminate
dissented	VBD	dissent
dissented	VBN	dissent
dissidents	NNS	dissident
dissipated	VBN	dissipate
dissociating	VBG	dissociate
dissolved	VBN	dissolve
dissolving	VBG	dissolve
distances	NNS	distance
distancing	VBG	distance
distilled	VBN	distill
distilling	VBG	distill
distinctions	NNS	distinction
distinguished	VBD	distinguish
distorted	VBN	distort
distortions	NNS	distortion
distorts	VBZ	distort
distracted	VBN	distract
distracting	VBG	distract
distractions	NNS	distraction
distributed	VBD	distribute
distributed	VBN	distribute
distributes	VBZ	distribute
distributing	VBG	distribute
distributions	NNS	distribution
districting	VBG	district
district	NNP	district
districts	NNS	district
disturbances	NNS	disturbance
disturbed	VBN	disturb
disturbing	VBG	disturb
disturbs	VBZ	disturb
dived	VBD	dive
diverging	VBG	diverge
diversifications	NNS	diversification
diversified	VBN	diversify
diversifying	VBG	diversify
diverted	VBN	divert
diverting	VBG	divert
divested	VBN	divest
divesting	VBG	divest
divided	VBD	divide
divided	VBN	divide
dividends	NNS	dividend
divides	VBZ	divide
divide	VBP	divide
dividing	VBG	divide
division	NNP	division
divisions	NNS	division
divorced	VBD	divorce
divorced	VBN	divorce
divvying	VBG	divvy
dizzying	VBG	dizzy
doctors	NNS	doctor
doctrines	NNS	doctrine
documentaries	NNS	documentary
documented	VBN	document
documenting	VBG	document
documents	NNS	document
dodged	VBD	dodge
dodge	VBP	dodge
doers	NNS	doer
does	VBZ	do
dogged	VBN	dog
dogging	VBG	dog
dogs	NNS	dog
doing	VBG	do
doldrums	NNS	doldrums
dollars	NNS	dollar
dominated	VBD	dominate
dominated	VBN	dominate
dominates	VBZ	dominate
dominate	VBP	dominate
dominating	VBG	dominate
donated	VBD	donate
donated	VBN	donate
donating	VBG	donate
donations	NNS	donation
done	VBD	do
done	VBN	do
donors	NNS	donor
dons	VBZ	don
doomed	VBN	doom
dooming	VBG	doom
doomsayers	NNS	doomsayers
doors	NNS	door
doses	NNS	dose
dotting	VBG	dot
dot	VBP	dot
doubled	VBD	double
doubled	VBN	double
doubles	VBZ	double
double	VBP	double
doubling	VBG	double
doubted	VBD	doubt
doubters	NNS	doubter
doubts	NNS	doubt
doubts	VBZ	doubt
doubt	VBP	doubt
do	VBP	do
dovetails	NNS	dovetail
downed	VBD	down
downgraded	VBD	downgrade
downgraded	VBN	downgrade
downs	NNS	down
downtown	NNP	downtown
dozens	NNS	dozens
drafted	VBD	draft
drafted	VBN	draft
drafting	VBG	draft
draft	VBN	draft
dragged	VBD	drag
dragged	VBN	drag
dragging	VBG	drag
drags	NNS	drag
drags	VBZ	drag
drained	VBN	drain
draining	VBG	drain
drains	VBZ	drain
dramatizations	NNS	dramatization
drawbacks	NNS	drawback
drawings	NNS	drawing
drawing	VBG	draw
drawn	VBN	draw
draws	VBZ	draw
draw	VBP	draw
dreaded	VBN	dread
dreamed	VBD	dream
dreamed	VBN	dream
dreaming	VBG	dream
dreams	NNS	dream
dream	VBP	dream
drenching	VBG	drench
dressed	VBD	dress
dressed	VBN	dress
dressing	VBG	dress
drew	VBD	draw
dried	VBD	dry
dried	VBN	dry
drifted	VBD	drift
drifting	VBG	drift
drift	VBP	drift
drilled	VBN	drill
drilling	VBG	drill
drinking	VBG	drink
drink	VBP	drink
dripping	VBG	drip
driven	VBN	drive
drivers	NNS	driver
drives	NNS	drive
drives	VBZ	drive
drive	VBP	drive
driving	NNP	drive
driving	VBG	drive
drooling	VBG	drool
dropouts	NNS	dropout
dropped	VBD	drop
dropped	VBN	drop
droppers	NNS	dropper
dropping	VBG	drop
drops	NNS	drop
drops	VBZ	drop
drop	VBP	drop
drove	VBD	drive
drowned	VBN	drown
drugs	NNS	drug
drumming	VBG	drum
drying	VBG	dry
dubbed	VBD	dub
dubbed	VBN	dub
dubs	VBZ	dub
ducking	VBG	duck
ducks	NNS	duck
duels	NNS	duel
dug	VBD	dig
dulled	VBN	dull
dumped	VBD	dump
dumped	VBN	dump
dumping	VBG	dump
dump	VBP	dump
duplicated	VBN	duplicate
duplicating	VBG	duplicate
dusted	VBD	dust
dusting	VBG	dust
duties	NNS	duty
dwarfed	VBN	dwarf
dwarfs	VBZ	dwarf
dwellers	NNS	dweller
dwellings	NNS	dwelling
dwindled	VBD	dwindle
dwindling	VBG	dwindle
dyed	VBN	dye
dying	VBG	die
dynamics	NNS	dynamics
earmarked	VBN	earmark
earmarking	VBG	earmark
earned	VBD	earn
earned	VBN	earn
earners	NNS	earner
earnings	NNS	earnings
earning	VBG	earn
earns	VBZ	earn
earn	VBP	earn
ears	NNS	ear
eased	VBD	ease
eases	VBZ	ease
easing	VBG	ease
eaten	VBN	eat
eaters	NNS	eater
eating	VBG	eat
eats	VBZ	eat
eat	VBP	eat
ebbs	VBZ	ebb
echoed	VBD	echo
echoed	VBN	echo
echoes	NNS	echo
echoing	VBG	echo
echo	VBP	echo
eclipsing	VBG	eclipse
economics	NNS	economics
economies	NNS	economy
economists	NNS	economist
edged	VBD	edge
edged	VBN	edge
edge	NNP	edge
edges	NNS	edge
edging	VBG	edge
editions	NNS	edition
editorials	NNS	editorial
editors	NNS	editor
educated	VBN	educate
educating	VBG	educate
effect	NNP	effect
effects	NNS	effects
efficiencies	NNS	efficiency
efforts	NNS	effort
egg	NNP	egg
eggs	NNS	eggs
egos	NNS	ego
ejected	VBN	eject
elaborating	VBG	elaborate
elapsed	VBN	elapse
elders	NNS	elder
elected	VBD	elect
elected	VBN	elect
elections	NNS	election
electrified	VBN	electrify
elements	NNS	elements
elevated	VBN	elevate
elevates	VBZ	elevate
eliminated	VBD	eliminate
eliminated	VBN	eliminate
eliminates	VBZ	eliminate
eliminate	VBP	eliminate
eliminating	VBG	eliminate
elitists	NNS	elitist
eluded	VBD	elude
embargoed	VBN	embargo
embargoes	NNS	embargo
embargos	NNS	embargo
embarked	VBD	embark
embarked	VBN	embark
embarrassed	VBN	embarrass
embarrassing	VBG	embarrass
embassies	NNS	embassy
embedded	VBN	embed
embezzled	VBD	embezzle
embezzling	VBG	embezzle
embodied	VBN	embody
embodies	VBZ	embody
embody	VBP	embody
emboldened	VBN	embolden
embraced	VBD	embrace
embraced	VBN	embrace
embraces	VBZ	embrace
embracing	VBG	embrace
embroiled	VBN	embroil
emerged	VBD	emerge
emerged	VBN	emerge
emergencies	NNS	emergency
emerges	VBZ	emerge
emerge	VBP	emerge
emerging	NNP	emerge
emerging	VBG	emerge
emigrated	VBD	emigrate
emissaries	NNS	emissary
emissions	NNS	emission
emitted	VBN	emit
emoted	VBN	emote
emotions	NNS	emotion
emphasized	VBD	emphasize
emphasized	VBN	emphasize
emphasizes	VBZ	emphasize
emphasizing	VBG	emphasize
employed	VBN	employ
employees	NNS	employee
employers	NNS	employer
employing	VBG	employ
employs	VBZ	employ
employ	VBP	employ
empowers	VBZ	empower
empower	VBP	empower
emptied	VBN	empty
emulated	VBN	emulate
emulating	VBG	emulate
enabled	VBD	enable
enabled	VBN	enable
enables	VBZ	enable
enable	VBP	enable
enabling	VBG	enable
enacted	VBD	enact
enacted	VBN	enact
enacting	VBG	enact
encasing	VBG	encase
encircling	VBG	encircle
enclosed	VBN	enclose
enclosing	VBG	enclose
encompassed	VBD	encompass
encountered	VBD	encounter
encountered	VBN	encounter
encounters	NNS	encounter
encounters	VBZ	encounter
encouraged	VBD	encourage
encouraged	VBN	encourage
encourages	VBZ	encourage
encourage	VBP	encourage
encouraging	VBG	encourage
encrypting	VBG	encrypt
encumbered	VBN	encumber
endangered	VBN	endanger
ended	VBD	end
ended	VBN	end
endings	NNS	ending
ending	VBG	end
end	NNP	end
endorsed	VBD	endorse
endorsed	VBN	endorse
endorsements	NNS	endorsement
endorse	VBP	endorse
endorsing	VBG	endorse
endowed	VBD	endow
endowed	VBN	endow
ends	NNS	end
ends	VBZ	end
endured	VBD	endure
endured	VBN	endure
enduring	VBG	endure
end	VBP	end
enemies	NNS	enemy
energies	NNS	energy
energized	VBN	energize
enforced	VBN	enforce
enforcement	NNP	enforcement
enforcers	NNS	enforcer
enforces	VBZ	enforce
enforcing	VBG	enforce
engaged	VBD	engage
engaged	VBN	engage
engagements	NNS	engagement
engages	VBZ	engage
engage	VBP	engage
engaging	VBG	engage
engineered	VBN	engineer
engineering	VBG	engineer
engineers	NNS	engineer
engines	NNS	engine
engraved	VBN	engrave
engulfed	VBN	engulf
enhanced	VBD	enhance
enhanced	VBN	enhance
enhancements	NNS	enhancement
enhances	VBZ	enhance
enhancing	VBG	enhance
enjoined	VBN	enjoin
enjoyed	VBD	enjoy
enjoyed	VBN	enjoy
enjoying	VBG	enjoy
enjoys	VBZ	enjoy
enjoy	VBP	enjoy
enlightened	VBN	enlighten
enlightening	VBG	enlighten
enlisted	VBD	enlist
enlisting	VBG	enlist
enlivening	VBG	enliven
enriching	VBG	enrich
enrich	VBP	enrich
enrolled	VBN	enroll
enrollees	NNS	enrollee
enrollments	NNS	enrollment
enroll	VBP	enroll
ensconced	VBN	ensconce
ensued	VBD	ensue
ensuing	VBG	ensue
ensures	VBZ	ensure
ensuring	VBG	ensure
entailed	VBN	entail
entails	NNS	entail
entangled	VBN	entangle
entered	VBD	enter
entered	VBN	enter
entering	VBG	enter
enter	NNP	enter
enterprises	NNS	enterprise
enters	VBZ	enter
entertained	VBD	entertain
entertained	VBN	entertain
enter	VBP	enter
enthusiasms	NNS	enthusiasm
enthusiasts	NNS	enthusiast
enticing	VBG	entice
entitled	VBN	entitle
entitlements	NNS	entitlement
entitles	VBZ	entitle
entitling	VBG	entitle
entombed	VBN	entomb
entranced	VBN	entrance
entrenched	VBN	entrench
entries	NNS	entry
entrust	VBP	entrust
entwined	VBN	entwine
environments	NNS	environment
envisaged	VBD	envisage
envisioned	VBN	envision
envisions	VBZ	envision
envision	VBP	envision
episodes	NNS	episode
equaled	VBD	equal
equaled	VBN	equal
equaling	VBG	equal
equals	VBZ	equal
equal	VBP	equal
equated	VBN	equate
equates	VBZ	equate
equipped	VBD	equip
equipped	VBN	equip
equips	VBZ	equip
equities	NNS	equity
equivalents	NNS	equivalent
era	NNP	era
erased	VBD	erase
erased	VBN	erase
erasing	VBG	erase
erected	VBD	erect
eroded	VBD	erode
eroded	VBN	erode
erodes	VBZ	erode
erode	VBP	erode
eroding	VBG	erode
erred	VBD	err
erred	VBN	err
errors	NNS	error
errs	VBZ	err
erupted	VBD	erupt
erupted	VBN	erupt
erupts	VBZ	erupt
escaped	VBD	escape
escaped	VBN	escape
escaping	VBG	escape
eschewed	VBN	eschew
escorts	VBZ	escort
espouse	VBP	espouse
essays	NNS	essay
established	VBD	establish
established	VBN	establish
establishes	VBZ	establish
establishing	VBG	establish
establishments	NNS	establishment
estimated	VBD	estimate
estimated	VBN	estimate
estimates	NNS	estimate
estimates	VBZ	estimate
estimate	VBP	estimate
estimating	VBG	estimate
estimators	NNS	estimator
estranged	VBN	estrange
ethics	NNS	ethics
evacuated	VBN	evacuate
evaded	VBN	evade
evaders	NNS	evaders
evades	VBZ	evade
evaluated	VBN	evaluate
evaluates	VBZ	evaluate
evaluating	VBG	evaluate
evaluations	NNS	evaluation
evaporated	VBD	evaporate
evened	VBN	even
evens	VBZ	even
events	NNS	event
evidenced	VBN	evidence
evinced	VBD	evince
eviscerating	VBG	eviscerate
evolved	VBD	evolve
evolved	VBN	evolve
evolving	VBG	evolve
exacerbated	VBD	exacerbate
exacerbated	VBN	exacerbate
exacerbates	VBZ	exacerbate
exacerbating	VBG	exacerbate
exaggerated	VBN	exaggerate
examinations	NNS	examination
examined	VBD	examine
examined	VBN	examine
examine	NNP	examine
examiners	NNS	examiner
examines	VBZ	examine
examining	VBG	examine
examples	NNS	example
excavated	VBN	excavate
excavating	VBG	excavate
exceeded	VBD	exceed
exceeded	VBN	exceed
exceeding	VBG	exceed
exceeds	VBZ	exceed
exceed	VBP	exceed
excerpts	NNS	excerpt
excesses	NNS	excess
exchanged	VBD	exchange
exchanged	VBN	exchange
exchange	NNP	exchange
exchanges	NNS	exchange
exchange	VBP	exchange
excited	VBN	excite
exclaims	VBZ	exclaim
excluded	VBN	exclude
excludes	VBZ	exclude
exclude	VBP	exclude
excluding	VBG	exclude
exclusions	NNS	exclusion
excoriated	VBN	excoriate
excursions	NNS	excursion
excused	VBN	excuse
excuses	NNS	excuse
executed	VBD	execute
executed	VBN	execute
executes	VBZ	execute
executing	VBG	execute
executions	NNS	execution
executives	NNS	executive
exemplifies	VBZ	exemplify
exempted	VBN	exempt
exempting	VBG	exempt
exemptions	NNS	exemption
exercised	VBD	exercise
exercised	VBN	exercise
exercises	NNS	exercise
exercises	VBZ	exercise
exercise	VBP	exercise
exercising	VBG	exercise
exerted	VBN	exert
exhaled	VBD	exhale
exhausted	VBN	exhaust
exhausting	VBG	exhaust
exhibiting	VBG	exhibit
exhibitions	NNS	exhibition
exhibits	VBZ	exhibit
exiled	VBN	exile
existed	VBD	exist
existed	VBN	exist
existing	VBG	exist
exists	VBZ	exist
exist	VBP	exist
exit	NNP	exit
exits	NNS	exit
exonerated	VBD	exonerate
exonerating	VBG	exonerate
expanded	VBD	expand
expanded	VBN	expand
expanding	VBG	expand
expands	VBZ	expand
expand	VBP	expand
expectations	NNS	expectation
expected	VBD	expect
expected	VBN	expect
expecting	VBG	expect
expect	NNP	expect
expects	VBZ	expect
expect	VBP	expect
expedited	VBN	expedite
expediting	VBG	expedite
expelled	VBN	expel
expended	VBN	expend
expenditures	NNS	expenditure
expenses	NNS	expense
experienced	VBD	experience
experienced	VBN	experience
experiences	NNS	experience
experience	VBP	experience
experiencing	VBG	experience
experimented	VBN	experiment
experimenting	VBG	experiment
experiments	NNS	experiment
experts	NNS	expert
expirations	NNS	expiration
expired	VBD	expire
expired	VBN	expire
expires	VBZ	expire
expire	VBP	expire
expiring	VBG	expire
explained	VBD	explain
explained	VBN	explain
explaining	VBG	explain
explains	VBZ	explain
explain	VBP	explain
explanations	NNS	explanation
exploded	VBD	explode
exploding	VBG	explode
exploited	VBN	exploit
exploiting	VBG	exploit
exploits	NNS	exploit
explores	VBZ	explore
exploring	VBG	explore
explosions	NNS	explosion
exported	VBD	export
exported	VBN	export
exporters	NNS	exporter
exporting	VBG	export
exports	NNS	export
exports	VBZ	export
exposed	VBD	expose
exposed	VBN	expose
expose	VBP	expose
exposing	VBG	expose
exposures	NNS	exposure
expounding	VBG	expound
expressed	VBD	express
expressed	VBN	express
expresses	VBZ	express
expressing	VBG	express
expressions	NNS	expression
express	VBP	express
extended	VBD	extend
extended	VBN	extend
extending	VBG	extend
extends	VBZ	extend
extend	VBP	extend
extensions	NNS	extension
extorted	VBD	extort
extorting	VBG	extort
extracted	VBD	extract
extracted	VBN	extract
extracting	VBG	extract
extradited	VBN	extradite
extraditions	NNS	extradition
extrapolated	VBN	extrapolate
extrusions	NNS	extrusion
exude	VBP	exude
eyeballing	VBG	eyeball
eyeballs	NNS	eyeball
eyebrows	NNS	eyebrow
eyeing	VBG	eye
eyes	NNS	eyes
fabricated	VBN	fabricate
facades	NNS	facade
faced	VBD	face
faced	VBN	face
faces	NNS	face
faces	VBZ	face
face	VBP	face
facilitating	VBG	facilitate
facilities	NNS	facility
facing	VBG	face
facsimiles	NNS	facsimile
factions	NNS	faction
factories	NNS	factory
factors	NNS	factor
facts	NNS	fact
faded	VBD	fade
faded	VBN	fade
failed	VBD	fail
failed	VBN	fail
failing	VBG	fail
fails	VBZ	fail
failures	NNS	failure
fail	VBP	fail
faked	VBD	fake
faked	VBN	fake
faking	VBG	fake
fallen	VBN	fall
falling	VBG	fall
falls	NNS	fall
falls	VBZ	fall
fall	VBP	fall
falsified	VBN	falsify
falsifying	VBG	falsify
faltered	VBD	falter
faltering	VBG	falter
falters	NNS	falter
falter	VBP	falter
families	NNS	family
fancies	VBZ	fancy
fanned	VBD	fan
fans	NNS	fan
fantasies	NNS	fantasy
fantasize	VBP	fantasize
fared	VBD	fare
fared	VBN	fare
fares	NNP	fare
fares	NNS	fare
fare	VBP	fare
farmers	NNS	farmer
farming	VBG	farm
farms	NNS	farm
fascinated	VBN	fascinate
fashioned	VBN	fashion
fastened	VBN	fasten
fatalities	NNS	fatality
fathers	NNS	father
fattened	VBN	fatten
fatten	VBP	fatten
faulted	VBN	fault
faults	NNS	fault
favored	VBD	favor
favored	VBN	favor
favoring	VBG	favor
favorites	NNS	favorite
favors	NNS	favor
favors	VBZ	favor
favor	VBP	favor
faxed	VBN	fax
feared	VBD	fear
feared	VBN	fear
fearing	VBG	fear
fears	NNS	fear
fears	VBZ	fear
fear	VBP	fear
feasted	VBN	feast
feats	NNS	feat
featured	VBD	feature
featured	VBN	feature
features	NNS	feature
features	VBZ	feature
feature	VBP	feature
featuring	VBG	feature
fed	VBD	feed
fed	VBN	feed
feeding	VBG	feed
feeds	VBZ	feed
feelings	NNS	feelings
feeling	VBG	feel
feels	VBZ	feel
feel	VBP	feel
fees	NNS	fee
feet	NNS	foot
felled	VBD	fell
fellows	NNS	fellow
fell	VBD	fall
felonies	NNS	felony
felt	VBD	feel
felt	VBN	feel
fended	VBD	fend
fending	VBG	fend
ferreting	VBG	ferret
ferrying	VBG	ferry
fertilized	VBN	fertilize
fertilizing	VBG	fertilize
festooned	VBD	festoon
festooning	VBG	festoon
fetched	VBD	fetch
fetches	VBZ	fetch
fetching	VBG	fetch
fetch	VBP	fetch
feuding	VBG	feud
feud	NNP	feud
fibers	NNS	fiber
fidgeting	VBG	fidget
fielded	VBD	field
fields	NNS	fields
fifths	NNS	fifth
fighting	VBG	fight
fight	NNP	fight
fights	NNS	fight
figured	VBD	figure
figured	VBN	figure
figure	NNP	figure
figures	NNS	figure
figures	VBZ	figure
figure	VBP	figure
figuring	VBG	figure
filched	VBN	filch
filed	VBD	file
filed	VBN	file
filers	NNS	filer
files	NNS	file
files	VBZ	file
file	VBP	file
filings	NNS	filing
filing	VBG	file
filled	VBD	fill
filled	VBN	fill
filling	VBG	fill
fills	VBZ	fill
fill	VBP	fill
filmed	VBN	film
filming	VBG	film
films	NNS	film
filtered	VBN	filter
filtering	VBG	filter
filters	NNS	filter
finagled	VBN	finagle
finalized	VBN	finalize
financed	VBN	finance
finances	NNS	finances
financiers	NNS	financier
financings	NNS	financing
financing	VBG	finance
findings	NNS	findings
finding	VBG	find
find	NNP	find
finds	NNS	find
finds	VBZ	find
find	VBP	find
fined	VBD	fine
fined	VBN	fine
fines	NNS	fine
fingered	VBN	finger
fingerprints	NNS	fingerprint
fingers	NNS	finger
finished	VBD	finish
finished	VBN	finish
finishes	NNS	finish
finishes	VBZ	finish
finishing	VBG	finish
fired	VBD	fire
fired	VBN	fire
firefighters	NNS	firefighter
fire	NNP	fire
fires	NNS	fire
fires	VBZ	fire
firmed	VBD	firm
firming	VBG	firm
fits	NNS	fit
fits	VBZ	fit
fit	VBP	fit
fixed	VBD	fix
fixed	VBN	fix
fixing	VBG	fix
fizzes	NNS	fizz
fizzled	VBN	fizzle
flabbergasted	VBN	flabbergast
flags	NNS	flag
flamed	VBD	flame
flanked	VBN	flank
flapping	VBG	flap
flaps	NNS	flaps
flared	VBN	flare
flaring	VBG	flare
flashbacks	NNS	flashback
flashed	VBD	flash
flashes	NNS	flash
flashes	VBZ	flash
flashing	VBG	flash
flash	VBP	flash
flattened	VBD	flatten
flattened	VBN	flatten
flaunts	VBZ	flaunt
flavors	NNS	flavor
flawed	VBN	flaw
flaws	NNS	flaw
fled	VBD	flee
fled	VBN	flee
fleeced	VBN	fleece
fleeing	VBG	flee
fleets	NNS	fleet
flew	VBD	fly
flickered	VBD	flicker
fliers	NNS	flier
flies	VBZ	fly
flights	NNS	flight
flinging	VBG	fling
flipped	VBD	flip
flipping	VBG	flip
flips	VBZ	flip
flirting	VBG	flirt
floated	VBD	float
floating	VBG	float
floats	NNS	float
flocked	VBD	flock
flocking	VBG	flock
flooded	VBD	flood
flooded	VBN	flood
flooding	VBG	flood
floors	NNS	floor
flopped	VBD	flop
flopped	VBN	flop
flotations	NNS	flotation
floundered	VBN	flounder
floundering	VBG	flounder
flourished	VBN	flourish
flourishing	VBG	flourish
flouting	VBG	flout
flowed	VBD	flow
flowing	VBG	flow
flown	VBN	fly
flows	NNS	flow
flows	VBZ	flow
flow	VBP	flow
fluctuated	VBD	fluctuate
fluctuated	VBN	fluctuate
fluctuate	VBP	fluctuate
fluctuations	NNS	fluctuation
flunking	VBG	flunk
flunk	VBP	flunk
flying	VBG	fly
fly	VBP	fly
foaming	VBG	foam
focused	VBD	focus
focused	VBN	focus
focuses	VBZ	focus
focusing	VBG	focus
focus	VBP	focus
foes	NNS	foe
foiled	VBN	foil
foiling	VBG	foil
folded	VBD	fold
folded	VBN	fold
folding	VBG	fold
followed	VBD	follow
followed	VBN	follow
followers	NNS	followers
following	VBG	follow
follows	VBZ	follow
follow	VBP	follow
fomenting	VBG	foment
foods	NNS	food
fooled	VBN	fool
fooling	VBG	fool
footing	VBG	foot
forays	NNS	foray
forbade	VBD	forbid
forbidden	VBN	forbid
forbidding	VBG	forbid
forbids	VBZ	forbid
forced	VBD	force
forced	VBN	force
forces	NNP	force
forces	NNS	force
forces	VBZ	force
force	VBP	force
forcing	VBG	force
forecasters	NNS	forecaster
forecasting	VBG	forecast
forecasts	NNS	forecast
forecasts	VBZ	forecast
forecast	VBD	forecast
forecast	VBN	forecast
forecast	VBP	forecast
foreclosed	VBN	foreclose
forerunners	NNS	forerunner
foreseen	VBN	foresee
foresees	VBZ	foresee
foresee	VBP	foresee
foreshadowed	VBN	foreshadow
forfeitures	NNS	forfeiture
forged	VBN	forge
forgeries	NNS	forgery
forgets	NNS	forget
forgetting	VBG	forget
forging	VBG	forge
forgiven	VBN	forgive
forgiving	VBG	forgive
forgotten	VBN	forget
forgot	VBD	forget
forgot	VBN	forget
forked	VBD	fork
forked	VBN	fork
formed	VBD	form
formed	VBN	form
forming	VBG	form
forms	NNS	form
forms	VBZ	form
formulated	VBN	formulate
formulates	VBZ	formulate
formulating	VBG	formulate
form	VBP	form
forsaken	VBN	forsake
fortunes	NNS	fortune
forwards	NNS	forward
fostered	VBD	foster
fostering	VBG	foster
fought	VBD	fight
fought	VBN	fight
fouled	VBN	foul
foundations	NNS	foundation
founded	VBD	found
founded	VBN	found
foundered	VBN	founder
foundering	VBG	founder
founding	NNP	found
founding	VBG	found
found	VBD	find
found	VBN	find
fourths	NNS	fourth
fracas	NNS	fracas
fractions	NNS	fraction
fractured	VBN	fracture
fragmented	VBN	fragment
fragments	NNS	fragment
frailties	NNS	frailty
framed	VBN	frame
framers	NNS	framer
frames	NNS	frame
framing	VBG	frame
franchised	VBN	franchise
franchisees	NNS	franchisees
franchisers	NNS	franchisers
franchises	NNS	franchise
franchising	VBG	franchise
francs	NNS	franc
frayed	VBN	fray
freaked	VBN	freak
freedoms	NNS	freedom
freed	VBD	free
freed	VBN	free
freeing	VBG	free
frees	VBZ	free
freezes	NNS	freeze
frequents	VBZ	frequent
freshmen	NNS	freshman
frets	VBZ	fret
fretting	VBG	fret
fret	VBD	fret
fret	VBP	fret
friendships	NNS	friendship
friends	NNS	friend
frightened	VBD	frighten
frightened	VBN	frighten
frittered	VBN	fritter
frittering	VBG	fritter
frolicked	VBN	frolic
fronts	NNS	front
frozen	VBN	freeze
fruits	NNS	fruit
frustrated	VBN	frustrate
fudge	VBP	fudge
fueled	VBD	fuel
fueled	VBN	fuel
fueling	VBG	fuel
fuels	NNS	fuel
fugitives	NNS	fugitive
fulfilled	VBD	fulfill
fulfilled	VBN	fulfill
fulfilling	VBG	fulfill
fulminations	NNS	fulmination
fumes	NNS	fumes
fuming	VBG	fume
functionaries	NNS	functionary
functioned	VBD	function
functioning	VBG	function
functions	NNS	function
function	VBP	function
fundamentals	NNS	fundamentals
funded	VBN	fund
funding	VBG	fund
fund	NNP	fund
funds	NNS	funds
funneled	VBN	funnel
funneling	VBG	funnel
furloughed	VBN	furlough
furnished	VBN	furnish
furrows	NNS	furrow
furthering	VBG	further
fusses	VBZ	fuss
gadgets	NNS	gadget
gained	VBD	gain
gained	VBN	gain
gainers	NNS	gainer
gaining	VBG	gain
gain	NNP	gain
gains	NNS	gain
gain	VBP	gain
gallons	NNS	gallon
galloping	VBG	gallop
galvanized	VBD	galvanize
galvanizing	VBG	galvanize
games	NNS	game
gaped	VBN	gape
gasped	VBD	gasp
gates	NNS	gates
gathered	VBD	gather
gathered	VBN	gather
gathering	VBG	gather
gave	VBD	give
gaze	VBP	gaze
geared	VBN	gear
gearing	VBG	gear
generalizations	NNS	generalization
generated	VBD	generate
generated	VBN	generate
generates	VBZ	generate
generate	VBP	generate
generating	VBG	generate
generations	NNS	generation
generators	NNS	generator
genes	NNS	gene
genocide	NNP	genocide
genres	NNS	genre
gestured	VBD	gesture
gestures	NNS	gesture
get	NNP	get
gets	VBZ	get
getters	NNS	getters
getting	VBG	get
get	VBP	get
ghosts	NNS	ghost
gifts	NNS	gift
gimmicks	NNS	gimmick
girded	VBD	gird
girding	VBG	gird
giveaways	NNS	giveaway
given	VBN	give
gives	NNS	give
gives	VBZ	give
give	VBP	give
giving	VBG	give
glanced	VBD	glance
glares	VBZ	glare
glaze	VBP	glaze
gleaming	VBG	gleam
gleaned	VBN	glean
gliding	VBG	glide
glimpses	NNS	glimpse
glitches	NNS	glitch
gloated	VBD	gloat
gloating	VBG	gloat
gloats	VBZ	gloat
glowed	VBD	glow
glued	VBN	glue
gluts	NNS	glut
glutted	VBN	glut
goals	NNS	goal
gobbled	VBN	gobble
goers	NNS	goer
goes	VBZ	go
goings	NNS	going
going	VBG	go
gone	NNP	go
gone	VBD	go
gone	VBN	go
go	NNP	go
gossiping	VBG	gossip
gotten	VBN	get
got	VBD	get
got	VBN	get
go	VBP	go
governed	VBN	govern
governing	VBG	govern
governments	NNS	government
governors	NNS	governor
grabbed	VBD	grab
grabbed	VBN	grab
grabbing	VBG	grab
grades	NNS	grade
graduated	VBD	graduate
graduates	NNS	graduate
grafted	VBD	graft
grains	NNS	grain
grams	NNS	gram
grandchildren	NNS	grandchild
grandees	NNS	grandee
grandkids	NNS	grandkids
granted	VBD	grant
granted	VBN	grant
granting	VBG	grant
grants	NNS	grant
grappled	VBD	grapple
grapples	NNS	grapple
grasping	VBG	grasp
graying	VBG	gray
grazed	VBD	graze
graze	VBP	graze
greeted	VBN	greet
greeting	VBG	greet
grew	VBD	grow
grievances	NNS	grievance
grimaced	VBD	grimace
grinding	VBG	grind
grinds	VBZ	grind
gripes	NNS	gripe
gripped	VBD	grip
gripping	VBG	grip
grips	NNS	grip
groans	VBZ	groan
grossing	VBG	gross
grounded	VBN	ground
grounding	VBG	ground
grounds	NNS	grounds
ground	VBN	grind
grouped	VBN	group
groups	NNS	group
groused	VBD	grouse
grouses	VBZ	grouse
grovels	VBZ	grovel
growers	NNS	grower
growing	VBG	grow
growls	VBZ	growl
grown	VBN	grow
grows	VBZ	grow
grow	VBP	grow
grumbled	VBD	grumble
grumble	VBP	grumble
guaranteed	VBD	guarantee
guaranteed	VBN	guarantee
guaranteeing	VBG	guarantee
guarantees	NNS	guarantee
guarantees	VBZ	guarantee
guarantee	VBP	guarantee
guarded	VBN	guard
guarding	VBG	guard
guards	NNS	guard
guerrillas	NNS	guerrilla
guessed	VBD	guess
guessing	VBP	guess
guess	VBP	guess
guests	NNS	guest
guided	VBN	guide
guidelines	NNS	guideline
guideposts	NNS	guidepost
guides	NNS	guide
guiding	VBG	guide
guilders	NNS	guilders
gunned	VBN	gun
gurus	NNS	guru
gushes	VBZ	gush
gush	VBP	gush
guts	NNS	guts
gyrated	VBD	gyrate
gyrating	VBG	gyrate
gyrations	NNS	gyration
habitats	NNS	habitat
habits	NNS	habit
hackles	NNS	hackles
had	VBD	have
had	VBN	have
haggling	VBG	haggle
hailed	VBD	hail
hailed	VBN	hail
hails	VBZ	hail
halls	NNS	hall
halted	VBD	halt
halted	VBN	halt
halting	VBG	halt
halts	NNS	halt
halt	VBP	halt
halved	VBN	halve
halves	NNS	halve
hammered	VBN	hammer
hamming	VBG	ham
hampered	VBN	hamper
hampering	VBG	hamper
hampers	VBZ	hamper
hamstrung	VBN	hamstring
handbooks	NNS	handbook
handcuffed	VBD	handcuff
handed	VBD	hand
handed	VBN	hand
handled	VBD	handle
handled	VBN	handle
handlers	NNS	handler
handles	VBZ	handle
handle	VBP	handle
handling	VBG	handle
hands	NNS	hands
hands	VBZ	hand
hanged	VBN	hang
hanging	VBG	hang
hangs	VBZ	hang
hang	VBP	hang
happened	VBD	happen
happened	VBN	happen
happenings	NNS	happening
happening	VBG	happen
happens	VBZ	happen
happen	VBP	happen
harangues	NNS	harangue
harassed	VBD	harass
harassing	VBG	harass
harboring	VBG	harbor
harbors	VBZ	harbor
hardened	VBN	harden
hardships	NNS	hardship
harmed	VBN	harm
harms	VBZ	harm
harried	VBN	harry
harvested	VBN	harvest
hashing	VBG	hash
hastened	VBN	hasten
has	VBZ	have
hatched	VBN	hatch
hated	VBN	hate
hates	VBZ	hate
hate	VBP	hate
hauled	VBD	haul
haulers	NNS	hauler
hauling	VBG	haul
haunted	VBN	haunt
haunting	VBG	haunt
haunts	NNS	haunt
havens	NNS	haven
have	VBP	have
having	VBG	have
hawking	VBG	hawk
hazards	NNS	hazard
headaches	NNS	headache
headed	VBD	head
headed	VBN	head
heading	VBG	head
headlines	NNS	headline
headquarters	NNS	headquarters
heads	NNS	head
heads	VBZ	head
head	VBP	head
healed	VBN	heal
heaped	VBD	heap
heard	VBD	hear
heard	VBN	hear
hearings	NNS	hearing
hearing	VBG	hear
hears	VBZ	hear
heartened	VBN	hearten
hearts	NNS	hearts
hear	VBP	hear
heaters	NNS	heater
heating	VBG	heat
heats	NNS	heat
heaved	VBN	heave
heaves	NNS	heave
hedging	VBG	hedge
heeded	VBD	heed
heels	NNS	heel
heightened	VBN	heighten
heights	NNS	heights
heirs	NNS	heir
held	VBD	hold
held	VBN	hold
helped	VBD	help
helped	VBN	help
helping	VBG	help
helps	VBZ	help
help	VBP	help
hemorrhaged	VBN	hemorrhage
hemorrhaging	VBG	hemorrhage
heralded	VBN	herald
herds	NNS	herd
heroes	NNS	hero
hesitate	VBP	hesitate
hesitating	VBG	hesitate
hewed	VBD	hew
hews	VBZ	hew
hidden	VBN	hide
hideouts	NNS	hideout
hiders	NNS	hiders
hiding	VBG	hide
highlighted	VBD	highlight
highlighted	VBN	highlight
highlighting	VBG	highlight
highlights	VBZ	highlight
highs	NNS	high
hightailing	VBG	hightail
highways	NNS	highway
hikes	NNS	hike
hiking	VBG	hike
hindered	VBD	hinder
hindered	VBN	hinder
hindering	VBG	hinder
hinders	NNS	hinder
hinted	VBD	hint
hinting	VBG	hint
hints	NNS	hint
hired	VBD	hire
hired	VBN	hire
hires	VBZ	hire
hire	VBP	hire
hiring	VBG	hire
hissed	VBD	hiss
hitched	VBN	hitch
hitches	NNS	hitch
hits	NNS	hit
hits	VBZ	hit
hitters	NNS	hitter
hitting	VBG	hit
hit	VBD	hit
hit	VBN	hit
hit	VBP	hit
hoards	NNS	hoard
hoard	VBP	hoard
hobbled	VBN	hobble
hobbling	VBG	hobble
hoe	NNP	hoe
holders	NNS	holder
holdings	NNS	holding
holding	VBG	hold
hold	NNP	hold
holdouts	NNS	holdout
holds	VBZ	hold
holdups	NNS	holdup
hold	VBP	hold
holed	VBN	hole
holes	NNS	hole
holidays	NNS	holiday
homecoming	VBG	homecoming
homes	NNS	home
honed	VBN	hone
honoring	VBG	honor
hoodwinked	VBD	hoodwink
hooked	VBN	hook
hooking	VBG	hook
hooks	VBZ	hook
hoped	VBD	hope
hoped	VBN	hope
hopes	NNS	hope
hopes	VBZ	hope
hope	VBP	hope
hoping	VBG	hope
hopping	VBG	hope
hops	VBZ	hope
horizons	NNS	horizon
horns	NNS	horn
horrors	NNS	horror
hospitalizations	NNS	hospitalization
hospitalized	VBN	hospitalize
hostages	NNS	hostage
hosted	VBD	host
hosting	VBG	host
hosts	NNS	host
hosts	VBZ	host
hounded	VBD	hound
hours	NNS	hours
housed	VBN	house
houses	NNS	house
hovered	VBD	hover
hovered	VBN	hover
hovering	VBG	hover
howling	VBG	howl
huckstering	VBG	huckster
huddled	VBD	huddle
hugged	VBN	hug
hulking	VBG	hulk
humanizing	VBG	humanize
humbled	VBN	humble
hunched	VBN	hunch
hundreds	NNS	hundred
hundredths	NNS	hundredth
hung	VBN	hang
hunters	NNS	hunter
hurdles	NNS	hurdles
hurled	VBN	hurl
hurling	VBG	hurl
hurl	VBP	hurl
hurricane	NNP	hurricane
hurting	VBG	hurt
hurtling	VBG	hurtle
hurts	VBZ	hurt
hurt	VBD	hurt
hurt	VBN	hurt
hurt	VBP	hurt
husbands	NNS	husband
hustles	VBZ	hustle
hyping	VBG	hyping
hypnotized	VBN	hypnotize
hypothesized	VBN	hypothesize
ideals	NNS	ideal
ideas	NNS	idea
identified	VBD	identify
identified	VBN	identify
identifies	VBZ	identify
identifying	VBG	identify
identify	VBP	identify
identities	NNS	identity
idled	VBD	idle
idled	VBN	idle
idling	VBG	idle
ignited	VBN	ignite
ignored	VBD	ignore
ignored	VBN	ignore
ignores	VBZ	ignore
ignore	VBP	ignore
ignoring	VBG	ignore
illnesses	NNS	illness
ills	NNS	ill
illustrated	VBN	illustrate
illustrates	VBZ	illustrate
illustrate	VBP	illustrate
illustrations	NNS	illustration
images	NNS	image
imagined	VBD	imagine
imagining	VBG	imagine
imbalances	NNS	imbalance
imitated	VBN	imitate
imitate	VBP	imitate
imitating	VBG	imitate
immersed	VBN	immerse
immigrants	NNS	immigrant
immigrated	VBD	immigrate
impaired	VBN	impair
impeached	VBN	impeach
impeded	VBN	impede
impediments	NNS	impediment
impelled	VBN	impel
impending	VBG	impend
imperatives	NNS	imperative
imperfections	NNS	imperfection
imperiled	VBN	imperil
impersonations	NNS	impersonation
implanted	VBD	implant
implanted	VBN	implant
implanting	VBG	implant
implants	NNS	implant
implemented	VBN	implement
implementing	VBG	implement
implicated	VBN	implicate
implications	NNS	implication
implied	VBD	imply
implied	VBN	imply
implies	VBZ	imply
implores	VBZ	implore
imploring	VBG	implore
implying	VBG	imply
imply	VBP	imply
imported	VBD	import
imported	VBN	import
importing	VBG	import
imports	NNS	import
imports	VBZ	import
imposed	VBD	impose
imposed	VBN	impose
imposes	VBZ	impose
imposing	VBG	impose
impounded	VBN	impound
impoverished	VBN	impoverish
impressed	VBN	impress
imprisoned	VBN	imprison
imprisoning	VBG	imprison
improved	VBD	improve
improved	VBN	improve
improvements	NNS	improvement
improves	VBZ	improve
improve	VBP	improve
improving	VBG	improve
improvised	VBD	improvise
impulses	NNS	impulse
inaugurated	VBN	inaugurate
incentives	NNS	incentive
inched	VBD	inch
inches	NNS	inch
inching	VBG	inch
incidents	NNS	incident
inciting	VBG	incite
inclined	VBN	incline
included	VBD	include
included	VBN	include
includes	VBZ	include
include	VBP	include
including	VBG	include
incomes	NNS	income
inconsistencies	NNS	inconsistency
incorporated	VBN	incorporate
incorporates	VBZ	incorporate
incorporating	VBG	incorporate
increased	VBD	increase
increased	VBN	increase
increases	NNS	increase
increases	VBZ	increase
increase	VBP	increase
increasing	VBG	increase
increments	NNS	increment
incriminating	VBG	incriminate
incurred	VBD	incur
incurred	VBN	incur
indexed	VBN	index
indexes	NNS	index
index	NNP	index
indicated	VBD	indicate
indicated	VBN	indicate
indicates	VBZ	indicate
indicate	VBP	indicate
indicating	VBG	indicate
indications	NNS	indication
indicators	NNS	indicator
indicted	VBD	indict
indicted	VBN	indict
indictments	NNS	indictment
indoctrinated	VBN	indoctrinate
induced	VBN	induce
induces	VBZ	induce
inducing	VBG	induce
indulgences	NNS	indulgence
indulges	VBZ	indulge
indulging	VBG	indulge
industrialized	VBN	industrialize
industries	NNS	industry
inequities	NNS	inequity
infected	VBN	infect
infections	NNS	infection
inferences	NNS	inference
inferred	VBN	infer
infiltrating	VBG	infiltrate
inflated	VBD	inflate
inflated	VBN	inflate
inflating	VBG	inflate
inflows	NNS	inflow
influenced	VBD	influence
influenced	VBN	influence
influences	NNS	influence
influences	VBZ	influence
influence	VBP	influence
informed	VBD	inform
informed	VBN	inform
informing	VBG	inform
informs	VBZ	inform
infractions	NNS	infraction
infringed	VBD	infringe
infringed	VBN	infringe
infringes	VBZ	infringe
infringing	VBG	infringe
infused	VBN	infuse
ingredients	NNS	ingredient
inhabited	VBN	inhabit
inhabits	VBZ	inhabit
inhabit	VBP	inhabit
inherited	VBD	inherit
inherited	VBN	inherit
inherit	VBP	inherit
inhibited	VBD	inhibit
inhibit	VBP	inhibit
initialed	VBD	initial
initiated	VBN	initiate
initiatives	NNS	initiative
injected	VBD	inject
injected	VBN	inject
injecting	VBG	inject
injects	VBZ	inject
injured	VBD	injure
injured	VBN	injure
injuries	NNS	injury
injuring	VBG	injure
injustices	NNS	injustice
inmates	NNS	inmate
innings	NNS	innings
innovated	VBD	innovate
innovations	NNS	innovation
inquired	VBD	inquire
inquiries	NNS	inquiry
inquiring	VBG	inquire
inserted	VBN	insert
inserting	VBG	insert
inserts	NNS	insert
insiders	NNS	insider
insights	NNS	insight
insisted	VBD	insist
insisted	VBN	insist
insisting	VBG	insist
insists	VBZ	insist
insist	VBP	insist
ins	NNS	ins
inspected	VBN	inspect
inspecting	VBG	inspect
inspections	NNS	inspection
inspectors	NNS	inspector
inspirations	NNS	inspiration
inspired	VBD	inspire
inspired	VBN	inspire
installations	NNS	installation
installed	VBD	install
installed	VBN	install
installing	VBG	install
installments	NNS	installment
instances	NNS	instance
instigated	VBD	instigate
instituted	VBD	institute
instituted	VBN	institute
instituting	VBG	institute
institutions	NNS	institution
instructed	VBD	instruct
instructed	VBN	instruct
instructing	VBG	instruct
instructions	NNS	instructions
instructors	NNS	instructor
instructs	VBZ	instruct
instruments	NNS	instrument
insulated	VBN	insulate
insulating	VBG	insulate
insurance	NNP	insurance
insured	VBD	insure
insured	VBN	insure
insurers	NNS	insurer
insures	VBZ	insure
insure	VBP	insure
insurgents	NNS	insurgent
insuring	VBG	insure
integrated	VBN	integrate
integrating	VBG	integrate
intended	VBD	intend
intended	VBN	intend
intends	VBZ	intend
intend	VBP	intend
intensified	VBD	intensify
intensifying	VBG	intensify
intentions	NNS	intention
intercepting	VBG	intercept
interconnected	VBN	interconnect
interested	VBN	interest
interests	NNS	interest
interfered	VBD	interfere
interferes	VBZ	interfere
interfering	VBG	interfere
interiors	NNS	interior
interloping	VBG	interlope
intermixed	VBD	intermix
interpretations	NNS	interpretation
interpreted	VBD	interpret
interpreted	VBN	interpret
interpreting	VBG	interpret
interprets	VBZ	interpret
interrogated	VBN	interrogate
interrupted	VBN	interrupt
interrupting	VBG	interrupt
interruptions	NNS	interruption
interspersed	VBN	intersperse
intertwined	VBN	intertwine
intertwining	VBG	intertwine
intervals	NNS	interval
intervened	VBD	intervene
intervened	VBN	intervene
intervening	VBG	intervene
interviewed	VBD	interview
interviewed	VBN	interview
interviewing	VBG	interview
interviews	NNS	interview
intimidated	VBN	intimidate
intimidating	VBG	intimidate
intones	VBZ	intone
introduced	VBD	introduce
introduced	VBN	introduce
introduces	VBZ	introduce
introducing	VBG	introduce
introductions	NNS	introduction
inundated	VBN	inundate
invaded	VBD	invade
invading	VBG	invade
invalidated	VBD	invalidate
invented	VBD	invent
invented	VBN	invent
inventing	VBG	invent
inventions	NNS	invention
inventories	NNS	inventory
inventors	NNS	inventor
inverted	VBN	invert
invested	VBD	invest
invested	VBN	invest
investigated	VBD	investigate
investigated	VBN	investigate
investigates	VBZ	investigate
investigating	VBG	investigate
investigations	NNS	investigation
investigators	NNS	investigator
investing	VBG	invest
investments	NNS	investment
investors	NNS	investor
invests	VBZ	invest
invest	VBP	invest
invitations	NNS	invitation
invited	VBD	invite
invited	VBN	invite
invites	VBZ	invite
inviting	VBG	invite
invokes	VBZ	invoke
invoking	VBG	invoke
involved	VBD	involve
involved	VBN	involve
involves	VBZ	involve
involve	VBP	involve
involving	VBG	involve
irked	VBN	irk
irks	VBZ	irk
irradiated	VBN	irradiate
irregularities	NNS	irregularity
irritates	VBZ	irritate
isolated	VBD	isolate
isolated	VBN	isolate
isolates	VBZ	isolate
isolate	VBP	isolate
issued	VBD	issue
issued	VBN	issue
issuers	NNS	issuer
issues	NNPS	issue
issues	NNS	issue
issues	VBZ	issue
issue	VBP	issue
issuing	VBG	issue
jabs	NNS	jab
jacked	VBD	jack
jacked	VBN	jack
jacking	VBG	jack
jailed	NNP	jail
jailed	VBD	jail
jailed	VBN	jail
jammed	VBD	jam
jammed	VBN	jam
jaunts	NNS	jaunt
jelled	VBD	jell
jeopardizes	VBZ	jeopardize
jeopardizing	VBG	jeopardize
jerked	VBN	jerk
jets	NNS	jets
jettisoning	VBG	jettison
jiggling	VBG	jiggle
jillions	NNS	jillion
jingling	VBG	jingle
jitters	NNS	jitters
jobs	NNS	job
jogs	NNS	jog
joined	VBD	join
joined	VBN	join
joining	VBG	join
join	NNP	join
joins	VBZ	join
join	VBP	join
jokes	NNS	joke
jokes	VBZ	joke
jolted	VBD	jolt
jolted	VBN	jolt
jolts	NNS	jolt
jousting	VBG	joust
judged	VBN	judge
judges	NNS	judges
judge	VBP	judge
judging	VBG	judge
judgments	NNS	judgment
juggling	VBG	juggle
jumped	VBD	jump
jumped	VBN	jump
jumping	VBG	jump
jumps	NNS	jump
jumps	VBZ	jump
jump	VBP	jump
junctures	NNS	juncture
junkets	NNS	junket
juries	NNS	jury
justified	VBN	justify
justifies	VBZ	justify
justifying	VBG	justify
jutting	VBG	jut
kayoed	VBN	kayo
keepers	NNS	keeper
keeping	VBG	keep
keeps	VBZ	keep
keep	VBP	keep
kept	VBD	keep
kept	VBN	keep
keyed	VBN	key
kicked	VBD	kick
kicked	VBN	kick
kickers	NNS	kicker
kicking	VBG	kick
kicks	VBZ	kick
kick	VBP	kick
kidnapped	VBN	kidnap
kids	NNS	kid
killed	VBD	kill
killed	VBN	kill
killers	NNS	killer
killings	NNS	killing
killing	VBG	kill
kills	NNS	kill
kills	VBZ	kill
kill	VBP	kill
kilometers	NNS	kilometer
kindled	VBN	kindle
kinds	NNS	kind
king	NNP	king
kingpins	NNS	kingpin
kings	NNS	king
kissing	NNP	kiss
kneaded	VBN	knead
kneading	VBG	knead
knees	NNS	knee
knew	VBD	know
knitting	VBG	knit
knocked	VBD	knock
knocked	VBN	knock
knocking	VBG	knock
knocks	VBZ	knock
knots	NNS	knot
knowing	VBG	know
knowns	NNS	knowns
known	VBN	know
knows	VBZ	know
know	VBP	know
labeled	VBD	label
labeled	VBN	label
labeling	VBG	label
labels	NNS	label
laboring	VBG	labor
labors	NNS	labor
laced	VBN	lace
lacked	VBD	lack
lacking	VBG	lack
lack	NNP	lack
lacks	VBZ	lack
lack	VBP	lack
lagged	VBD	lag
lagged	VBN	lag
lagging	VBG	lag
lags	VBZ	lag
lag	VBP	lag
laid	VBD	lay
laid	VBN	lay
lambasted	VBD	lambaste
lambastes	VBZ	lambaste
lamented	VBD	lament
laments	NNS	lament
landed	VBD	land
landed	VBN	land
landings	NNS	landing
land	NNP	land
languages	NNS	language
languished	VBD	languish
languished	VBN	languish
languishes	NNS	languish
languishing	VBG	languish
lapsed	VBN	lapse
lapses	NNS	lapse
lashed	VBD	lash
lasted	VBD	last
lasted	VBN	last
lasting	VBG	last
lasts	VBZ	last
latches	VBZ	latch
latching	VBG	latch
latch	VBP	latch
lauded	VBD	laud
lauded	VBN	laud
laughed	VBD	laugh
laughed	VBN	laugh
laughing	VBG	laugh
laughs	VBZ	laugh
launched	VBD	launch
launched	VBN	launch
launches	NNS	launch
launches	VBZ	launch
launching	VBG	launch
laundered	VBD	launder
laundered	VBN	launder
launderers	NNS	launderers
laundering	VBG	launder
lavished	VBN	lavish
lavishing	VBG	lavish
lawmakers	NNS	lawmaker
laws	NNS	laws
lawsuits	NNS	lawsuit
lawyers	NNS	lawyer
layers	NNS	layer
laying	VBG	lay
layoffs	NNS	layoff
lays	VBZ	lay
lay	VBD	lay
lay	VBP	lay
leaders	NNS	leaders
leading	VBG	lead
leads	NNP	lead
leads	NNS	lead
leads	VBZ	lead
lead	VBP	lead
leaked	VBD	leak
leaked	VBN	leak
leaking	VBG	leak
leaned	VBD	lean
leaned	VBN	lean
leaning	VBG	lean
lean	NNP	lean
leans	VBZ	lean
leaped	VBD	leap
leaping	VBG	leap
learned	VBD	learn
learned	VBN	learn
learning	VBG	learn
learns	VBZ	learn
learn	VBP	learn
leased	VBD	lease
leased	VBN	lease
leases	NNS	lease
leases	VBZ	lease
leasing	VBG	lease
leaves	NNS	leaf
leaves	VBZ	leave
leave	VBP	leave
leaving	VBG	leave
lectured	VBD	lecture
led	VBD	lead
led	VBN	lead
left	NNP	leave
left	VBD	leave
left	VBN	leave
legalizing	VBG	legalize
legions	NNS	legion
legislators	NNS	legislator
legislatures	NNS	legislature
legitimized	VBN	legitimize
legs	NNS	legs
lenders	NNS	lender
lending	VBG	lend
lends	VBZ	lend
lend	VBP	lend
lengthened	VBN	lengthen
lengthens	NNS	lengthen
lengthen	VBP	lengthen
lent	VBD	lend
lent	VBN	lend
lessers	NNS	lessers
lessons	NNS	lesson
lets	VBZ	let
letter	NNP	letter
letters	NNS	letters
letting	VBG	let
let	VBD	let
let	VBN	let
let	VBP	let
leveled	VBD	level
leveled	VBN	level
leveling	VBG	level
levels	NNS	level
levied	VBD	levy
liabilities	NNS	liabilities
liaisons	NNS	liaison
libeled	VBN	libel
liberalized	VBD	liberalize
liberalized	VBN	liberalize
liberalizing	VBG	liberalize
liberated	VBN	liberate
licensed	VBD	license
licensed	VBN	license
licenses	NNS	license
licenses	VBZ	license
license	VBP	license
licensing	VBG	license
licking	VBG	lick
lied	VBD	lie
lies	NNP	lie
lies	NNS	lie
lies	VBZ	lie
lieutenants	NNS	lieutenant
lie	VBP	lie
life	NNP	life
lifted	VBD	lift
lifted	VBN	lift
lifting	VBG	lift
lifts	NNS	lift
lighted	VBN	light
lightened	VBD	lighten
lightening	VBG	lighten
lighting	VBG	light
liked	VBD	like
likened	VBD	liken
likes	NNS	like
likes	VBZ	like
like	VBP	like
limbs	NNS	limb
limitations	NNS	limitation
limited	VBD	limit
limited	VBN	limit
limiting	VBG	limit
limits	NNS	limit
limits	VBZ	limit
limit	VBP	limit
lined	VBD	line
lined	VBN	line
liners	NNS	liner
lines	NNS	line
lineups	NNS	lineup
lingering	VBG	linger
linger	NNP	linger
lingers	VBZ	linger
lining	VBG	line
linkages	NNS	linkage
linked	VBD	link
linked	VBN	link
linking	VBG	link
link	NNP	link
links	NNS	links
links	VBZ	link
lips	NNS	lip
liquefied	VBN	liquify
liquefies	VBZ	liquify
liquidated	VBN	liquidate
liquidating	VBG	liquidate
lire	NNS	lira
listed	VBD	list
listed	VBN	list
listened	VBD	listen
listeners	NNS	listener
listening	VBG	listen
listens	VBZ	listen
listen	VBP	listen
listings	NNS	listing
listing	VBG	list
lists	NNS	list
lists	VBZ	list
litigators	NNS	litigator
lived	VBD	live
lived	VBN	live
lives	NNS	life
lives	VBZ	live
live	VBP	live
living	VBG	live
loaded	VBD	load
loaded	VBN	load
loading	VBG	load
loads	NNS	loads
loaned	VBD	loan
loaned	VBN	loan
loans	NNS	loan
loathed	VBD	loathe
loathed	VBN	loathe
lobbied	VBD	lobby
lobbied	VBN	lobby
lobbies	NNS	lobby
lobbying	VBG	lobby
lobbyists	NNS	lobbyist
localized	VBN	localize
located	VBN	locate
locating	VBG	locate
locations	NNS	location
locked	VBD	lock
locked	VBN	lock
locking	VBG	lock
locks	NNS	lock
locks	VBZ	lock
lock	VBP	lock
locutions	NNS	locution
lodged	VBN	lodge
logged	VBD	log
logged	VBN	log
logos	NNS	logos
logs	VBZ	log
log	VBD	log
loitering	VBG	loiter
looked	VBD	look
looked	VBN	look
looking	VBG	look
looks	NNS	look
looks	VBZ	look
look	VBP	look
looming	VBG	loom
looms	VBZ	loom
loom	VBP	loom
loosened	VBN	loosen
lorded	VBD	lord
losers	NNS	loser
loses	VBZ	lose
lose	VBP	lose
losing	VBG	lose
losses	NNS	losses
lost	NNP	lose
lost	VBD	lose
lost	VBN	lose
lots	NNS	lots
loved	VBD	love
loved	VBN	love
lovers	NNS	lover
loves	VBZ	love
love	VBP	love
lowered	VBD	lower
lowered	VBN	lower
lowering	VBG	lower
lowers	NNS	lower
lowers	VBZ	lower
lows	NNS	low
loyalties	NNS	loyalty
lugging	VBG	lug
lulled	VBN	lull
lumped	VBN	lump
lumping	VBG	lump
lumps	VBZ	lump
lunged	VBD	lunge
lungs	NNS	lung
lurched	VBD	lurch
lurching	VBG	lurch
lured	VBD	lure
lured	VBN	lure
lures	VBZ	lure
luring	VBG	lure
lurking	VBG	lurk
lying	VBG	lie
lyrics	NNS	lyric
machine	NNP	machine
machines	NNS	machine
made	VBD	make
made	VBN	make
magazines	NNS	magazine
magistrates	NNS	magistrate
magnetized	VBD	magnetize
magnified	VBD	magnify
magnified	VBN	magnify
mailed	VBN	mail
mailing	VBG	mail
mailmen	NNS	mailman
mainstream	NNP	mainstream
maintained	VBD	maintain
maintained	VBN	maintain
maintaining	VBG	maintain
maintains	VBZ	maintain
maintain	VBP	maintain
majoring	VBG	major
makers	NNS	maker
makes	VBZ	make
make	VBP	make
making	VBG	make
malfunctions	NNS	malfunction
managed	VBD	manage
managed	VBN	manage
management	NNP	management
managements	NNS	management
managers	NNS	manager
manages	VBZ	manage
manage	VBP	manage
managing	VBG	manage
mandated	VBD	mandate
mandated	VBN	mandate
mandates	VBZ	mandate
mandating	VBG	mandate
maneuvered	VBD	maneuver
maneuvers	NNS	maneuver
manhandled	VBN	manhandle
manifestations	NNS	manifestation
manifestos	NNS	manifesto
manipulated	VBN	manipulate
manipulates	VBZ	manipulate
manipulating	VBG	manipulate
manipulations	NNS	manipulation
manned	VBD	man
manners	NNS	manners
manuals	NNS	manual
manufactured	VBD	manufacture
manufactured	VBN	manufacture
manufacturers	NNS	manufacturer
manufactures	VBZ	manufacture
manufacturing	VBG	manufacture
maps	NNS	map
marched	VBD	march
marched	VBN	march
marches	NNS	marches
marching	VBG	march
march	VBP	march
marginalizing	VBG	marginalize
margins	NNS	margin
marked	VBD	mark
marked	VBN	mark
marketed	VBD	market
marketed	VBN	market
marketers	NNS	marketer
marketing	VBG	market
market	NNP	market
markets	NNS	market
markets	VBZ	market
market	VBP	market
marking	VBG	mark
marks	NNS	marks
marks	VBZ	mark
mark	VBP	mark
married	VBD	marry
married	VBN	marry
marrying	VBG	marry
marveled	VBD	marvel
masked	VBN	mask
masquerading	VBG	masquerade
massages	NNS	massage
massaging	VBG	massage
massed	VBD	mass
mastered	VBN	master
masterpieces	NNS	masterpiece
matched	VBD	match
matched	VBN	match
matches	VBZ	match
matching	VBG	match
match	VBP	match
mated	VBN	mate
materialized	VBD	materialize
materialized	VBN	materialize
materializes	VBZ	materialize
mates	NNS	mates
mattered	VBN	matter
matters	NNS	matter
matters	VBZ	matter
matter	VBP	matter
matured	VBN	mature
matures	VBZ	mature
mature	VBP	mature
maturing	VBG	mature
maturities	NNS	maturity
maximizing	VBG	maximize
maxims	NNS	maxim
mazes	NNS	maze
meanders	VBZ	meander
meaning	VBG	mean
means	NNP	mean
means	NNS	means
means	VBZ	mean
meant	VBD	mean
meant	VBN	mean
mean	VBP	mean
measured	VBD	measure
measured	VBN	measure
measurements	NNS	measurement
measures	NNS	measure
measures	VBZ	measure
measuring	VBG	measure
mechanisms	NNS	mechanism
meddling	VBG	meddle
media	NNS	medium
meetings	NNS	meeting
meeting	VBG	meet
meets	VBZ	meet
meet	VBP	meet
megabytes	NNS	megabyte
megawatts	NNS	megawatt
melding	VBG	meld
melts	VBZ	melt
memberships	NNS	membership
members	NNS	member
mementos	NNS	memento
memoirs	NNS	memoir
memorabilia	NNS	memorabilia
memorandums	NNS	memorandum
memorialized	VBN	memorialize
memories	NNS	memory
memory	NNP	memory
memos	NNS	memo
mentioned	VBD	mention
mentioned	VBN	mention
mentioning	VBG	mention
mentions	VBZ	mention
mention	VBP	mention
merchandised	VBN	merchandise
merchants	NNS	merchant
merged	VBD	merge
merged	VBN	merge
mergers	NNS	merger
merge	VBP	merge
merging	VBG	merge
merits	NNS	merit
messages	NNS	message
messing	VBG	mess
metabolized	VBN	metabolize
metals	NNS	metal
metaphors	NNS	metaphor
meters	NNS	meter
methodologies	NNS	methodology
methods	NNS	method
met	VBD	meet
met	VBN	meet
middlemen	NNS	middleman
middle	NNP	middle
miffed	VBD	miff
migrations	NNS	migration
miles	NNS	mile
milestones	NNS	milestone
militias	NNS	militia
millions	NNS	million
mills	NNS	mills
mimics	VBZ	mimic
mimic	VBP	mimic
minds	NNS	mind
miners	NNS	miner
mines	NNS	mine
mingle	VBP	mingle
miniaturized	VBN	miniaturize
minimized	VBN	minimize
minimizing	VBG	minimize
mining	VBG	mine
ministers	NNS	minister
minting	VBG	mint
minutes	NNS	minutes
mired	VBN	mire
mirrored	VBD	mirror
mirror	VBP	mirror
misadventures	NNS	misadventure
miscalculated	VBD	miscalculate
misdeeds	NNS	misdeed
misfortunes	NNS	misfortune
mishandled	VBD	mishandle
mishandling	VBG	mishandle
misinterpreted	VBN	misinterpret
misjudgments	NNS	misjudgments
mislaid	VBN	mislay
misleading	VBG	mislead
misled	VBD	mislead
misled	VBN	mislead
misperceptions	NNS	misperceptions
misplaced	VBN	misplace
misrepresentations	NNS	misrepresentation
misrepresented	VBD	misrepresent
misrepresenting	VBG	misrepresent
misrepresents	NNS	misrepresent
missed	VBD	miss
missed	VBN	miss
misses	VBZ	miss
missing	VBG	miss
missions	NNS	mission
misspent	VBN	misspend
misstated	VBD	misstate
misstated	VBN	misstate
misstatements	NNS	misstatement
misstates	VBZ	misstate
miss	VBP	miss
mistakes	NNS	mistake
mistresses	NNS	mistress
misunderstanding	VBG	misunderstand
misunderstood	VBN	misunderstand
misused	VBD	misuse
mitigating	VBG	mitigate
mixed	VBN	mix
mixers	NNS	mixer
mixes	VBZ	mix
mixing	VBG	mix
mixtures	NNS	mixture
moaning	VBG	moan
moans	VBZ	moan
mobilized	VBN	mobilize
mocked	VBN	mock
modeled	VBD	model
modeled	VBN	model
modeling	VBG	model
models	NNS	model
moderating	VBG	moderate
modernized	VBN	modernize
modernizing	VBG	modernize
modes	NNS	mode
modifications	NNS	modification
modified	VBN	modify
modifies	VBZ	modify
modulate	VBP	modulate
moisturizers	NNS	moisturizers
molecules	NNS	molecule
moments	NNS	moment
monitored	VBD	monitor
monitored	VBN	monitor
monitoring	VBG	monitor
monitors	VBZ	monitor
monitor	VBP	monitor
monologues	NNS	monologue
monopolies	NNS	monopoly
monopolized	VBD	monopolize
monopolizing	VBG	monopolize
months	NNS	month
moonlighting	VBG	moonlight
moons	NNS	moon
mopping	VBG	mop
morals	NNS	morals
mornings	NNS	morning
mortgages	NNS	mortgage
mothers	NNP	mother
mothers	NNS	mother
motivated	VBN	motivate
motivating	VBG	motivate
motives	NNS	motive
motorized	VBN	motorize
motors	NNS	motor
mounds	NNS	mound
mounted	VBD	mount
mounted	VBN	mount
mounting	VBG	mount
mounts	VBZ	mount
mount	VBP	mount
mourning	VBG	mourn
mouthed	VBN	mouth
mouths	NNS	mouth
moved	VBD	move
moved	VBN	move
movements	NNS	movement
moves	NNP	move
moves	NNS	move
moves	VBZ	move
move	VBP	move
movies	NNS	movie
moving	VBG	move
mucked	VBN	muck
muddied	VBN	muddy
muddled	VBN	muddle
mulling	VBG	mull
mulls	VBZ	mull
multiples	NNS	multiple
multiplied	VBN	multiply
mumbled	VBN	mumble
munching	VBG	munch
murdered	VBN	murder
murdering	VBG	murder
murders	NNS	murder
muscled	VBD	muscle
muscles	NNS	muscle
muscling	VBG	muscle
muses	VBZ	muse
mushroomed	VBD	mushroom
mushroomed	VBN	mushroom
musicians	NNS	musician
mutated	VBN	mutate
mutilated	VBN	mutilate
mutinies	NNS	mutiny
muzzles	VBZ	muzzle
mysteries	NNS	mystery
myths	NNS	myth
naggings	NNS	naggings
nagging	VBG	nag
nailed	VBN	nail
named	VBD	name
named	VBN	name
names	NNS	names
naming	VBG	name
narrowed	VBD	narrow
narrowed	VBN	narrow
narrowing	VBG	narrow
narrows	VBZ	narrow
nationalists	NNS	nationalist
nationalized	VBN	nationalize
nationals	NNS	national
nations	NNS	nation
navies	NNS	navy
neared	VBD	near
nearing	VBG	near
nears	VBZ	near
necessitated	VBD	necessitate
necessitated	VBN	necessitate
necessities	NNS	necessity
necks	NNS	neck
needed	VBD	need
needed	VBN	need
needing	VBG	need
needs	NNS	need
needs	VBZ	need
need	VBP	need
negated	VBN	negate
negatives	NNS	negative
neglected	VBN	neglect
neglecting	VBG	neglect
negotiated	VBD	negotiate
negotiated	VBN	negotiate
negotiating	VBG	negotiate
negotiations	NNS	negotiation
negotiators	NNS	negotiator
neighborhoods	NNS	neighborhood
neighboring	VBG	neighbor
neighbors	NNS	neighbor
nerves	NNS	nerves
nests	NNS	nest
nets	NNS	net
netting	VBG	net
networks	NNS	network
neutralizes	VBZ	neutralize
newcomers	NNS	newcomer
newscasts	NNS	newscast
news	NNP	news
niches	NNS	niche
nicked	VBN	nick
nicknamed	VBD	nickname
nicknamed	VBN	nickname
nicknames	NNS	nickname
nightmares	NNS	nightmare
nods	VBZ	nod
nominated	VBD	nominate
nominated	VBN	nominate
nomination	NNP	nomination
nominations	NNS	nomination
nominees	NNS	nominee
norms	NNS	norm
nosediving	VBG	nosedive
noses	NNS	nose
noted	VBD	note
noted	VBN	note
notes	NNS	note
notes	VBZ	note
note	VBP	note
noticed	VBD	notice
noticed	VBN	notice
notices	NNS	notice
notice	VBP	notice
notifications	NNS	notification
notified	VBD	notify
notified	VBN	notify
notifying	VBG	notify
noting	VBG	note
notions	NNS	notion
novels	NNS	novel
nuances	NNS	nuance
numbered	VBD	number
numbered	VBN	number
numbers	NNS	numbers
nursed	VBD	nurse
nursing	VBG	nurse
nurtured	VBD	nurture
objected	VBD	object
objecting	VBG	object
objections	NNS	objection
objectives	NNS	objective
objects	NNS	object
object	VBP	object
obligated	VBN	obligate
obligations	NNS	obligation
obliged	VBN	oblige
obliges	VBZ	oblige
obliterated	VBN	obliterate
obscured	VBD	obscure
observations	NNS	observation
observed	VBD	observe
observed	VBN	observe
observers	NNS	observer
observes	VBZ	observe
observe	VBP	observe
observing	VBG	observe
obstacles	NNS	obstacle
obstructed	VBN	obstruct
obstructing	VBG	obstruct
obstruct	VBP	obstruct
obtained	VBD	obtain
obtained	VBN	obtain
obtaining	VBG	obtain
obtain	VBP	obtain
occasions	NNS	occasions
occupied	VBD	occupy
occupies	VBZ	occupy
occurred	VBD	occur
occurred	VBN	occur
occurring	VBG	occur
occurs	VBZ	occur
occur	VBP	occur
odds	NNS	odds
offenders	NNS	offender
offending	VBG	offend
offends	VBZ	offend
offered	NNP	offer
offered	VBD	offer
offered	VBN	offer
offerings	NNS	offering
offering	VBG	offer
offers	NNS	offer
offers	VBZ	offer
offer	VBP	offer
office	NNP	office
officers	NNS	officer
offices	NNS	office
officials	NNS	official
offsetting	VBG	offset
offset	VBD	offset
offset	VBN	offset
offset	VBP	offset
offshoots	NNS	offshoot
offs	NNS	offs
ogles	VBZ	ogle
ogling	VBG	ogle
omissions	NNS	omission
omits	NNS	omit
omits	VBZ	omit
omitted	VBD	omit
omitted	VBN	omit
omit	VBP	omit
ons	NNS	ons
oozing	VBG	ooze
opened	VBD	open
opened	VBN	open
openers	NNS	opener
openings	NNS	opening
opening	VBG	open
open	NNP	open
opens	VBZ	open
open	VBP	open
operated	VBD	operate
operated	VBN	operate
operates	VBZ	operate
operate	VBP	operate
operating	VBG	operate
operations	NNS	operations
operative	NNP	operative
operatives	NNS	operative
operators	NNS	operator
opining	VBG	opine
opinion	NNP	opinion
opinions	NNS	opinion
opponents	NNS	opponent
opportunities	NNS	opportunity
opposed	VBD	oppose
opposed	VBN	oppose
opposes	VBZ	oppose
oppose	VBP	oppose
opposing	VBG	oppose
opted	VBD	opt
opting	VBG	opt
options	NNS	option
opt	VBP	opt
orchestrated	VBN	orchestrate
orchestrating	VBG	orchestrate
ordained	VBN	ordain
ordered	VBD	order
ordered	VBN	order
ordering	VBG	order
order	NNP	order
orders	NNS	order
orders	VBZ	order
ordinances	NNS	ordinance
organizations	NNS	organization
organized	NNP	organize
organized	VBD	organize
organized	VBN	organize
organizers	NNS	organizer
organizing	VBG	organize
organs	NNS	organs
oriented	VBN	orient
originated	VBN	originate
originates	VBZ	originate
originating	VBG	originate
originations	NNS	origination
originators	NNS	originator
origins	NNS	origin
orphaned	VBN	orphan
others	NNS	others
ounces	NNS	ounce
ousted	VBD	oust
ousted	VBN	oust
outages	NNS	outage
outbidding	VBG	outbid
outbreaks	NNS	outbreak
outdone	VBN	outdo
outfielders	NNS	outfielder
outfits	NNS	outfit
outflows	NNS	outflow
outgrew	VBD	outgrow
outgrown	VBN	outgrow
outlasted	VBD	outlast
outlawed	VBN	outlaw
outlawing	VBG	outlaw
outlays	NNS	outlay
outlets	NNS	outlet
outlined	VBD	outline
outlined	VBN	outline
outlines	VBZ	outline
outlining	VBG	outline
outlooks	NNS	outlook
outnumbered	VBD	outnumber
outpaced	VBD	outpace
outpace	VBP	outpace
outpacing	VBG	outpace
outpost	NNP	outpost
outposts	NNS	outpost
outraged	VBN	outrage
outselling	VBG	outsell
outsells	VBZ	outsell
outskirts	NNS	outskirts
outs	NNS	out
outstripped	VBD	outstrip
outstripped	VBN	outstrip
outstrips	VBZ	outstrip
outweighed	VBD	outweigh
outweighed	VBN	outweigh
outweigh	VBP	outweigh
overbid	VBD	overbid
overcame	VBD	overcome
overcharges	NNS	overcharge
overcomes	VBZ	overcome
overcome	VBN	overcome
overdosed	VBN	overdose
overdosing	VBG	overdose
overflowing	VBG	overflow
overhanging	VBG	overhang
overhauled	VBN	overhaul
overhauling	VBG	overhaul
overhaul	NNP	overhaul
overhead	NNP	overhead
overheated	VBN	overheat
overlapping	VBG	overlap
overlays	VBZ	overlay
overlooked	VBD	overlook
overlooked	VBN	overlook
overlooking	VBG	overlook
overlooks	VBZ	overlook
overlook	VBP	overlook
overpaid	VBD	overpay
overpaid	VBN	overpay
overpriced	VBN	overprice
overreacted	VBN	overreact
overreacting	VBG	overreact
overriding	VBG	override
overruling	VBG	overrule
overruns	NNS	overrun
oversaw	VBD	oversee
overseeing	VBG	oversee
overseen	VBN	oversee
overseers	NNS	overseer
oversees	VBZ	oversee
overshadowed	VBN	overshadow
overshadowing	VBG	overshadow
oversimplified	VBN	oversimplify
oversold	VBN	oversell
overstated	VBN	overstate
overstating	VBG	overstate
overtaken	VBN	overtake
overtaxed	VBN	overtax
overthrowing	VBG	overthrow
overtures	NNS	overture
overturned	VBD	overturn
overturning	VBG	overturn
overvalued	VBN	overvalue
overwhelmed	VBN	overwhelm
overwhelming	VBG	overwhelm
overworking	VBG	overwork
owed	VBD	owe
owed	VBN	owe
owes	VBZ	owe
owe	VBP	owe
owned	VBD	own
owned	VBN	own
owners	NNS	owner
owning	VBG	own
owns	VBZ	own
own	VBP	own
pacified	VBN	pacify
packaged	VBN	package
packages	NNS	package
packages	VBZ	package
packaging	VBG	package
packed	VBD	pack
packed	VBN	pack
packets	NNS	packet
packs	NNS	pack
packs	VBZ	pack
pacts	NNS	pact
paeans	NNS	paean
pages	NNS	page
paid	VBD	pay
paid	VBN	pay
pains	NNS	pains
painted	VBD	paint
painted	VBN	paint
paintings	NNS	painting
painting	VBG	paint
paint	VBP	paint
paired	VBN	pair
pairs	NNS	pair
paled	VBD	pale
pales	VBZ	pale
pampers	VBZ	pamper
panels	NNS	panel
pangs	NNS	pang
panicked	VBD	panic
panicking	VBG	panic
panjandrums	NNS	panjandrum
panned	VBD	pan
panned	VBN	pan
panning	VBG	pan
papers	NNS	papers
parachuting	VBG	parachute
parallels	NNS	parallel
parallels	VBZ	parallel
paralyzed	VBN	paralyze
paralyzing	VBG	paralyze
parameters	NNS	parameter
pardoned	VBD	pardon
pared	VBN	pare
parent	NNP	parent
parents	NNS	parent
paring	VBG	pare
parked	VBN	park
parking	VBG	park
park	NNP	park
parliament	NNP	parliament
parried	VBD	parry
participants	NNS	participant
participated	VBD	participate
participated	VBN	participate
participates	VBZ	participate
participate	VBP	participate
participating	VBG	participate
particulars	NNS	particular
parties	NNS	party
partnerships	NNS	partnership
partners	NNS	partner
parts	NNS	parts
party	NNP	party
passed	VBD	pass
passed	VBN	pass
passengers	NNS	passenger
passes	NNS	pass
passes	VBZ	pass
passing	VBG	pass
passions	NNS	passion
pass	VBP	pass
passwords	NNS	password
pasteurized	VBN	pasteurize
pastimes	NNS	pastime
pastors	NNS	pastor
patched	VBN	patch
patented	VBN	patent
patents	NNS	patent
paths	NNS	path
patients	NNS	patient
patrolled	VBN	patrol
patrols	NNS	patrol
patronized	VBN	patronize
patrons	NNS	patron
patterned	VBN	pattern
patterns	NNS	pattern
paused	VBD	pause
pauses	VBZ	pause
pausing	VBG	pause
paved	VBN	pave
pawing	VBG	paw
pawning	VBG	pawn
paychecks	NNS	paycheck
payers	NNS	payer
paying	VBG	pay
payments	NNS	payment
pay	NNP	pay
payouts	NNS	payouts
payrolls	NNS	payroll
pays	VBZ	pay
pay	VBP	pay
peaked	VBD	peak
peaked	VBN	peak
peaking	VBG	peak
peaks	NNS	peak
pecks	NNS	peck
peck	VBP	peck
peculiarities	NNS	peculiarity
pedaled	VBN	pedal
pedaling	VBG	pedal
peddled	VBN	peddle
peddles	VBZ	peddle
peddle	VBP	peddle
peddling	VBG	peddle
peeking	VBG	peek
peeled	VBN	peel
peering	VBG	peer
peers	NNS	peer
pegged	VBD	peg
pegged	VBN	peg
pegging	VBG	peg
pegs	VBZ	peg
penalized	VBN	penalize
penalizes	VBZ	penalize
penalties	NNS	penalty
penetrated	VBN	penetrate
penetrating	VBG	penetrate
penned	VBN	pen
pensions	NNS	pension
perceived	VBD	perceive
perceived	VBN	perceive
perceives	VBZ	perceive
perceive	VBP	perceive
percentages	NNS	percentage
perceptions	NNS	perception
perched	VBD	perch
perched	VBN	perch
perfected	VBN	perfect
performances	NNS	performance
performed	VBD	perform
performed	VBN	perform
performers	NNS	performer
performing	VBG	perform
performs	VBZ	perform
perform	VBP	perform
periods	NNS	period
perked	VBD	perk
perked	VBN	perk
perks	NNS	perk
permeated	VBD	permeate
permeating	VBG	permeate
permits	NNS	permit
permits	VBZ	permit
permitted	VBD	permit
permitted	VBN	permit
permitting	VBG	permit
permit	VBP	permit
perpetrated	VBN	perpetrate
perpetuate	VBP	perpetuate
perpetuating	VBG	perpetuate
persecuted	VBN	persecute
persecuting	VBG	persecute
persisted	VBD	persist
persisting	VBG	persist
persists	VBZ	persist
personalities	NNS	personality
personalized	VBN	personalize
personnel	NNS	personnel
persuaded	VBD	persuade
persuaded	VBN	persuade
persuades	VBZ	persuade
persuading	VBG	persuade
perturbed	VBD	perturb
peruse	VBP	peruse
perversities	NNS	perversity
pesetas	NNS	peseta
pestered	VBN	pester
petitions	NNS	petition
phased	VBN	phase
phases	NNS	phase
phasing	VBG	phase
philosophies	NNS	philosophy
phoned	VBD	phone
phoned	VBN	phone
phoning	VBG	phone
photographing	VBG	photograph
photographs	NNS	photograph
photos	NNS	photo
picked	VBD	pick
picked	VBN	pick
pickers	NNS	picker
picking	VBG	pick
picks	NNS	pick
picks	VBZ	pick
pick	VBP	pick
pictured	VBN	picture
pictures	NNS	picture
pictures	VBZ	picture
picturing	VBG	picture
pieced	VBN	piece
pieces	NNS	piece
piggybacking	VBG	piggyback
piled	VBD	pile
piles	NNS	piles
piling	VBG	pile
pillars	NNS	pillar
pillorying	VBG	pillory
pilots	NNS	pilot
pinching	VBG	pinch
pinging	VBG	ping
pinned	VBN	pin
pinning	VBG	pin
pinpointed	VBN	pinpoint
pints	NNS	pint
pioneered	VBD	pioneer
pioneers	NNS	pioneer
piped	VBD	pipe
piped	VBN	pipe
pipelines	NNS	pipeline
pirated	VBN	pirate
pistils	NNS	pistil
pitched	VBD	pitch
pitched	VBN	pitch
pitches	NNS	pitch
pitches	VBZ	pitch
pitching	VBG	pitch
pitfalls	NNS	pitfall
pits	NNS	pit
pitted	VBN	pit
placated	VBN	placate
placed	VBD	place
placed	VBN	place
placements	NNS	placement
places	NNS	place
places	VBZ	place
place	VBP	place
placing	VBG	place
plagued	VBD	plague
plagued	VBN	plague
planks	NNS	plank
planned	VBD	plan
planned	VBN	plan
planners	NNS	planner
planning	VBG	plan
plan	NNP	plan
plans	NNS	plan
plans	VBZ	plan
plantations	NNS	plantation
planted	VBD	plant
planted	VBN	plant
planting	VBG	plant
plan	VBP	plan
played	VBD	play
played	VBN	play
players	NNS	player
playing	VBG	play
plays	NNS	play
plays	VBZ	play
play	VBP	play
pleaded	VBD	plead
pleaded	VBN	plead
pleading	VBG	plead
pleased	VBD	please
pleased	VBN	please
pleases	VBZ	please
pleas	NNS	plea
pleasures	NNS	pleasure
pledged	VBD	pledge
pledged	VBN	pledge
pledges	NNS	pledge
pledging	VBG	pledge
plies	VBZ	ply
plights	NNS	plight
plots	NNS	plot
plotted	VBN	plot
plotters	NNS	plotter
plotting	VBG	plot
plowed	VBN	plow
plows	VBZ	plow
ploys	NNS	ploy
plucked	VBN	pluck
plugged	VBD	plug
plugging	VBG	plug
plug	VBP	plug
plummeted	VBD	plummet
plummeted	VBN	plummet
plummeting	VBG	plummet
plummet	VBP	plummet
plunged	VBD	plunge
plunged	VBN	plunge
plunges	VBZ	plunge
plunge	VBP	plunge
plunging	VBG	plunge
plying	VBG	pry
poaching	VBG	poach
pocketing	VBG	pocket
pockets	NNS	pocket
pockmarked	VBN	pockmark
pointed	VBD	point
pointed	VBN	point
pointers	NNS	pointer
pointing	VBG	point
points	NNS	point
points	VBZ	point
point	VBD	point
point	VBP	point
poised	VBN	poise
poisoned	VBN	poison
poked	VBD	poke
pokes	VBZ	poke
poking	VBG	poke
polices	NNS	police
policies	NNS	policy
policing	VBG	police
policyholders	NNS	policyholder
policy	NNP	policy
polished	VBN	polish
polishing	VBG	polish
politicized	VBN	politicize
politics	NNS	politics
polled	VBD	poll
polled	VBN	poll
pollinated	VBN	pollinate
pollinate	VBP	pollinate
pollinating	VBG	pollinate
poll	NNP	poll
polls	NNS	polls
pollutants	NNS	pollutant
pondering	VBG	ponder
pontificate	VBP	pontificate
pooled	VBN	pool
pooling	VBG	pool
pools	NNS	pool
popping	VBG	pop
pops	VBZ	pop
popularized	VBD	popularize
populated	VBN	populate
populating	VBG	populate
populations	NNS	population
pop	VBP	pop
pored	VBN	pore
pores	VBZ	pore
portends	VBZ	portend
portfolios	NNS	portfolio
portions	NNS	portion
portraits	NNS	portrait
portrayed	VBD	portray
portrayed	VBN	portray
portraying	VBG	portray
portrays	VBZ	portray
posed	VBD	pose
posed	VBN	pose
poses	VBZ	pose
posing	VBG	pose
positioned	VBN	position
positions	NNS	position
possessed	VBD	possess
possesses	VBZ	possess
possessing	VBG	possess
possessions	NNS	possession
possess	VBP	possess
possibilities	NNS	possibility
posted	VBD	post
posted	VBN	post
postings	NNS	posting
posting	VBG	post
postmarked	VBN	postmark
postponed	VBD	postpone
postponed	VBN	postpone
postponing	VBG	postpone
posts	NNS	post
potentates	NNS	potentate
potentialities	NNS	potentiality
pounded	VBN	pound
pounding	VBG	pound
pounds	NNS	pound
poured	VBD	pour
poured	VBN	pour
pouring	VBG	pour
pours	VBZ	pour
powered	VBN	power
powerhouses	NNS	powerhouse
powers	NNS	power
practiced	VBD	practice
practiced	VBN	practice
practices	NNS	practice
practicing	VBG	practice
practitioners	NNS	practitioner
praised	VBD	praise
praised	VBN	praise
praises	NNS	praise
praising	VBG	praise
prancing	VBG	prance
praying	VBG	pray
prearranged	VBN	prearrange
precautions	NNS	precaution
preceded	VBN	precede
preceding	VBG	precede
precipitated	VBD	precipitate
precluded	VBN	preclude
predates	VBZ	predate
predators	NNS	predator
predecessors	NNS	predecessor
predetermined	VBN	predetermine
predicted	VBD	predict
predicted	VBN	predict
predicting	VBG	predict
predictions	NNS	prediction
predicts	VBZ	predict
predict	VBP	predict
pre-empted	VBD	pre-empt
preferences	NNS	preference
preferred	VBD	prefer
preferred	VBN	prefer
preferring	VBG	prefer
prefers	VBZ	prefer
prefer	VBP	prefer
prejudices	NNS	prejudice
premiered	VBD	premiere
premiering	VBG	premiere
premiums	NNS	premium
preoccupied	VBN	preoccupy
prepaid	VBN	prepay
preparations	NNS	preparation
prepared	VBD	prepare
prepared	VBN	prepare
preparers	NNS	preparers
prepares	VBZ	prepare
prepare	VBP	prepare
preparing	VBG	prepare
prepaying	VBG	prepay
prepayments	NNS	prepayment
prerogatives	NNS	prerogative
presages	VBZ	presage
prescribed	VBN	prescribe
prescribes	VBZ	prescribe
prescribe	VBP	prescribe
prescriptions	NNS	prescription
presentations	NNS	presentation
presented	VBD	present
presented	VBN	present
presenting	VBG	present
presents	VBZ	present
preserved	VBN	preserve
preserves	VBZ	preserve
preserving	VBG	preserve
presided	VBD	preside
presidents	NNS	president
presides	VBZ	preside
presiding	VBG	preside
pressed	VBD	press
pressed	VBN	press
presses	NNS	press
pressing	VBG	press
press	NNP	press
pressured	VBD	pressure
pressured	VBN	pressure
pressures	NNS	pressure
pressure	VBP	pressure
pressuring	VBG	pressure
press	VBP	press
presumed	VBN	presume
pretensions	NNS	pretension
prevailed	VBD	prevail
prevailed	VBN	prevail
prevailing	VBG	prevail
prevails	VBZ	prevail
prevail	VBP	prevail
prevented	VBD	prevent
prevented	VBN	prevent
preventing	VBG	prevent
prevents	VBZ	prevent
prevent	VBP	prevent
previewing	VBG	preview
previews	NNS	preview
prey	VBP	prey
priced	VBD	price
priced	VBN	price
prices	NNS	price
pricings	NNS	pricing
pricing	VBG	price
primed	VBN	prime
principals	NNS	principal
principles	NNS	principle
printed	VBN	print
printers	NNS	printer
printing	VBG	print
prints	NNS	print
print	VBP	print
priorities	NNS	priority
prisoners	NNS	prisoner
privatized	VBN	privatize
privatizing	VBG	privatize
privileges	NNS	privilege
prized	VBN	prize
prizes	NNS	prize
probabilities	NNS	probability
probes	NNS	probe
probing	VBG	probe
problematics	NNS	problematics
problems	NNS	problem
procedures	NNS	procedure
proceeded	VBD	proceed
proceedings	NNS	proceedings
proceeding	VBG	proceed
proceeds	NNS	proceeds
proceeds	VBZ	proceed
processed	VBN	process
processes	NNS	process
processes	VBZ	process
processing	VBG	process
processors	NNS	processor
proclaimed	VBD	proclaim
proclaiming	VBG	proclaim
proclaims	VBZ	proclaim
proclaim	VBP	proclaim
proclamations	NNS	proclamation
prodded	VBN	prod
prodding	VBG	prod
prods	VBZ	prod
produced	VBD	produce
produced	VBN	produce
producers	NNS	producer
produces	VBZ	produce
produce	VBP	produce
producing	VBG	produce
productions	NNS	production
products	NNS	product
professed	VBD	profess
professed	VBN	profess
professes	VBZ	profess
professionals	NNS	professional
professions	NNS	profession
professors	NNS	professor
proffered	VBD	proffer
proffered	VBN	proffer
profiled	VBN	profile
profiles	NNS	profile
profited	VBD	profit
profiteering	VBG	profiteer
profiting	VBG	profit
profits	NNS	profits
profits	VBZ	profit
programmed	VBN	program
programmers	NNS	programmer
programs	NNS	program
progressed	VBD	progress
progresses	VBZ	progress
progressing	VBG	progress
progressions	NNS	progression
progress	NNP	progress
prohibited	VBD	prohibit
prohibited	VBN	prohibit
prohibiting	VBG	prohibit
prohibitions	NNS	prohibition
prohibits	VBZ	prohibit
prohibit	VBP	prohibit
projected	VBD	project
projected	VBN	project
projecting	VBG	project
projections	NNS	projection
projects	NNS	project
projects	VBZ	project
project	VBP	project
proliferated	VBN	proliferate
proliferate	VBP	proliferate
proliferating	VBG	proliferate
prolonged	VBN	prolong
promised	VBD	promise
promised	VBN	promise
promises	NNS	promise
promises	VBZ	promise
promise	VBP	promise
promising	VBG	promise
promoted	VBN	promote
promoters	NNS	promoter
promotes	VBZ	promote
promoting	VBG	promote
promotions	NNS	promotion
prompted	VBD	prompt
prompted	VBN	prompt
prompting	VBG	prompt
prompts	VBZ	prompt
promulgated	VBD	promulgate
pronounced	VBN	pronounce
pronounces	VBZ	pronounce
proofreading	VBG	proofread
propelled	VBD	propel
propelled	VBN	propel
properties	NNS	property
proponents	NNS	proponent
proportions	NNS	proportion
proposals	NNS	proposal
proposed	VBD	propose
proposed	VBN	propose
proposes	VBZ	propose
proposing	VBG	propose
propped	VBD	prop
propping	VBG	prop
proprietorships	NNS	proprietorship
proprietors	NNS	proprietor
prosecuted	VBD	prosecute
prosecuted	VBN	prosecute
prosecuting	VBG	prosecute
prosecutions	NNS	prosecution
prosecutors	NNS	prosecutor
pros	NNS	pro
prospects	NNS	prospect
prospered	VBN	prosper
protected	VBD	protect
protected	VBN	protect
protecting	VBG	protect
protection	NNP	protection
protections	NNS	protection
protectors	NNS	protector
protects	VBZ	protect
protect	VBP	protect
proteins	NNS	protein
protested	VBD	protest
protested	VBN	protest
protesters	NNS	protester
protesting	VBG	protest
protests	NNS	protest
protocols	NNS	protocol
proved	VBD	prove
proved	VBN	prove
proven	VBN	prove
proves	VBZ	prove
provided	VBD	provide
provided	VBN	provide
providers	NNS	provider
provides	VBZ	provide
provide	VBP	provide
providing	VBG	provide
provinces	NNS	province
proving	VBG	prove
provisions	NNS	provisions
provoked	VBD	provoke
provoked	VBN	provoke
provoking	VBG	provoke
pruned	VBN	prune
publications	NNS	publication
publicized	VBN	publicize
published	VBD	publish
published	VBN	publish
publishers	NNS	publisher
publishes	VBZ	publish
publishing	VBG	publish
pulled	VBD	pull
pulled	VBN	pull
pulling	VBG	pull
pulls	VBZ	pull
pull	VBP	pull
pulverizing	VBG	pulverize
pummeled	VBD	pummel
pummeled	VBN	pummel
pummeling	VBG	pummel
pumped	VBD	pump
pumped	VBN	pump
pumping	VBG	pump
pumps	NNS	pump
punching	VBG	punch
punished	VBN	punish
punishing	VBG	punish
purchased	VBD	purchase
purchased	VBN	purchase
purchasers	NNS	purchaser
purchases	NNS	purchase
purchases	VBZ	purchase
purchase	VBP	purchase
purchasing	VBG	purchase
purged	VBD	purge
purged	VBN	purge
purges	VBZ	purge
purging	VBG	purge
purists	NNS	purist
purports	NNS	purport
purport	VBP	purport
purposes	NNS	purpose
purrs	VBZ	purr
pursued	VBD	pursue
pursued	VBN	pursue
pursuers	NNS	pursuer
pursues	VBZ	pursue
pursue	VBP	pursue
pursuing	VBG	pursue
pursuits	NNS	pursuit
pushed	VBD	push
pushed	VBN	push
pushers	NNS	pusher
pushes	VBZ	push
pushing	VBG	push
push	VBP	push
puts	NNS	put
puts	VBZ	put
putting	VBG	put
put	VBD	put
put	VBN	put
put	VBP	put
puzzled	VBD	puzzle
puzzled	VBN	puzzle
pyramiding	VBG	pyramid
quacks	VBZ	quack
quadrupled	VBN	quadruple
quadruples	VBZ	quadruple
qualifications	NNS	qualification
qualified	VBD	qualify
qualified	VBN	qualify
qualifies	VBZ	qualify
qualifying	VBG	qualify
qualify	VBP	qualify
qualities	NNS	quality
quantified	VBN	quantify
quantities	NNS	quantity
quarreling	VBG	quarrel
quarters	NNS	quarters
quashed	VBD	quash
queried	VBN	query
queries	NNS	query
questioned	VBD	question
questioned	VBN	question
questioning	VBG	question
questions	NNS	question
questions	VBZ	question
question	VBP	question
quibbling	VBG	quibble
quieted	VBD	quiet
quieted	VBN	quiet
quieting	VBG	quiet
quipped	VBD	quip
quips	NNS	quip
quips	VBZ	quip
quirks	NNS	quirk
quits	VBZ	quit
quit	VBD	quit
quit	VBP	quit
quotas	NNS	quota
quotations	NNS	quotation
quoted	VBD	quote
quoted	VBN	quote
quotes	NNS	quote
quotes	VBZ	quote
quoting	VBG	quote
raced	VBD	race
races	NNS	race
racing	VBG	race
racked	VBD	rack
racked	VBN	rack
racking	VBG	rack
racks	NNS	rack
radioing	VBG	radio
raged	VBD	rage
raged	VBN	rage
rages	NNS	rage
raging	VBG	rage
raided	VBD	raid
raided	VBN	raid
raiders	NNS	raider
rails	NNS	rail
rained	VBD	rain
rains	NNS	rain
raised	VBD	raise
raised	VBN	raise
raisers	NNS	raiser
raises	NNS	raise
raises	VBZ	raise
raise	VBP	raise
raising	VBG	raise
raking	VBG	rake
rallied	VBD	rally
rallied	VBN	rally
rallies	NNS	rally
rallying	VBG	rally
rally	VBP	rally
rambled	VBD	ramble
rammed	VBD	ram
ramps	NNS	ramp
ranged	VBD	range
ranges	NNS	range
ranges	VBZ	range
range	VBP	range
ranging	VBG	range
rang	VBD	ring
ranked	VBD	rank
ranking	VBG	rank
rankled	VBN	rankle
ranks	NNS	rank
ranks	VBZ	rank
ran	VBD	run
raped	VBD	rape
raped	VBN	rape
raping	VBG	rape
rated	VBD	rate
rated	VBN	rate
rates	NNS	rates
rates	VBZ	rate
ratified	VBD	ratify
ratified	VBN	ratify
ratifying	VBG	ratify
ratings	NNS	rating
rationalizations	NNS	rationalization
rationalizing	VBG	rationalize
ratios	NNP	ratio
ratios	NNS	ratio
rattled	VBD	rattle
rattled	VBN	rattle
rattling	VBG	rattle
ravaged	VBN	ravage
ravages	NNS	ravage
raves	VBZ	rave
razed	VBN	raze
reached	VBD	reach
reached	VBN	reach
reaches	NNS	reach
reaches	VBZ	reach
reaching	VBG	reach
reach	VBP	reach
reacted	VBD	react
reacted	VBN	react
reacting	VBG	react
reactions	NNS	reaction
reacts	VBZ	react
react	VBP	react
readers	NNS	reader
reading	NNP	read
readings	NNS	reading
reading	VBG	read
reads	VBZ	read
read	VBD	read
read	VBN	read
read	VBP	read
reaffirmed	VBD	reaffirm
reaffirming	VBG	reaffirm
reaffirms	VBZ	reaffirm
realignments	NNS	realignments
realities	NNS	reality
reality	NNP	reality
realized	VBD	realize
realized	VBN	realize
realizes	VBZ	realize
realize	VBP	realize
realizing	VBG	realize
realms	NNS	realm
reams	NNS	ream
reaped	VBN	reap
reapportion	VBP	reapportion
reappraised	VBD	reappraise
reappraised	VBN	reappraise
reap	VBP	reap
reared	VBN	rear
rearing	VBG	rear
rearranges	VBZ	rearrange
reasoned	VBD	reason
reasons	NNS	reason
reasons	VBZ	reason
reasserting	VBG	reassert
reassessing	VBG	reassess
reassigned	VBD	reassign
reassigned	VBN	reassign
reassured	VBN	reassure
reassuring	VBG	reassure
rebates	NNS	rebate
rebounded	VBD	rebound
rebounded	VBN	rebound
rebounding	VBG	rebound
rebounds	VBZ	rebound
rebound	VBD	rebound
rebuffed	VBD	rebuff
rebuffed	VBN	rebuff
rebuilding	VBG	rebuild
rebuilt	VBN	rebuild
rebutted	VBN	rebut
recalculated	VBD	recalculate
recalculating	VBG	recalculate
recalculations	NNS	recalculation
recalled	VBD	recall
recalling	VBG	recall
recalls	NNS	recall
recalls	VBZ	recall
recall	VBP	recall
recanted	VBD	recant
recanted	VBN	recant
receipts	NNS	receipts
receivables	NNS	receivables
received	VBD	receive
received	VBN	receive
receivers	NNS	receiver
receives	VBZ	receive
receive	VBP	receive
receiving	VBG	receive
recessed	VBN	recess
recessions	NNS	recession
recharging	VBG	recharge
recipes	NNS	recipe
recipients	NNS	recipient
recites	VBZ	recite
reciting	VBG	recite
reckoned	VBN	reckon
reckons	VBZ	reckon
reckon	VBP	reckon
reclaiming	VBG	reclaim
reclaims	VBZ	reclaim
reclassified	VBD	reclassify
recognized	VBD	recognize
recognized	VBN	recognize
recognizes	VBZ	recognize
recognize	VBP	recognize
recognizing	VBG	recognize
recommendations	NNS	recommendation
recommended	VBD	recommend
recommended	VBN	recommend
recommending	VBG	recommend
recommends	VBZ	recommend
recommend	VBP	recommend
reconsidered	VBN	reconsider
reconstructed	VBN	reconstruct
reconstructing	VBG	reconstruct
recorded	VBD	record
recorded	VBN	record
recorders	NNS	recorder
recordings	NNS	recording
recording	VBG	record
record	NNP	record
records	NNS	record
records	VBZ	record
recounted	VBD	recount
recounted	VBN	recount
recounting	VBG	recount
recounts	VBZ	recount
recouped	VBD	recoup
recovered	VBD	recover
recovered	VBN	recover
recoveries	NNS	recovery
recovering	VBG	recover
recover	VBP	recover
recruited	VBD	recruit
recruited	VBN	recruit
recruiting	VBG	recruit
recruits	NNS	recruit
recruits	VBZ	recruit
rectifying	VBG	rectify
recurring	VBG	recur
recycled	VBN	recycle
recycles	VBZ	recycle
recycling	VBG	recycle
redeemed	VBN	redeem
redefined	VBN	redefine
redefining	VBG	redefine
redemptions	NNS	redemption
redesigned	VBN	redesign
redesigning	VBG	redesign
redirected	VBN	redirect
redlining	VBG	redline
redoing	VBG	redo
redoubling	VBG	redouble
reduced	VBD	reduce
reduced	VBN	reduce
reduces	VBZ	reduce
reduce	VBP	reduce
reducing	VBG	reduce
reduction	NNP	reduction
reductions	NNS	reduction
reeled	VBD	reel
reeling	VBG	reel
reexamining	VBG	reexamine
refashioning	VBG	refashion
references	NNS	reference
referrals	NNS	referral
referred	VBD	refer
referred	VBN	refer
referring	VBG	refer
refers	VBZ	refer
refer	VBP	refer
refinanced	VBN	refinance
refinancing	VBG	refinance
refined	VBN	refine
refineries	NNS	refinery
refiners	NNS	refiner
refining	VBG	refine
reflected	VBD	reflect
reflected	VBN	reflect
reflecting	VBG	reflect
reflects	VBZ	reflect
reflect	VBP	reflect
refocused	VBN	refocus
refocuses	NNS	refocus
refocusing	VBG	refocus
reformed	VBN	reform
reformers	NNS	reformer
reforming	VBG	reform
reforms	NNS	reform
reformulated	VBN	reformulate
refugees	NNS	refugee
refunding	VBG	refund
refunds	NNS	refund
refurbished	VBD	refurbish
refurbished	VBN	refurbish
refurbishing	VBG	refurbish
refused	VBD	refuse
refused	VBN	refuse
refuses	VBZ	refuse
refuse	VBP	refuse
refusing	VBG	refuse
refuted	VBD	refute
regained	VBD	regain
regained	VBN	regain
regaining	VBG	regain
regains	VBZ	regain
regain	VBP	regain
regarded	VBD	regard
regarded	VBN	regard
regarding	VBG	regard
regards	VBZ	regard
regard	VBP	regard
regions	NNS	region
registered	VBD	register
registered	VBN	register
registering	VBG	register
register	VBP	register
registrations	NNS	registration
regrets	NNS	regrets
regrets	VBZ	regret
regretted	VBD	regret
regulated	VBN	regulate
regulates	VBZ	regulate
regulating	VBG	regulate
regulation	NNP	regulation
regulations	NNS	regulation
regulators	NNS	regulator
rehashing	VBG	rehash
reigned	VBD	reign
reigning	VBG	reign
reignited	VBN	reignite
reimbursed	VBN	reimburse
reimbursements	NNS	reimbursement
reimburses	VBZ	reimburse
reinforced	VBD	reinforce
reinforced	VBN	reinforce
reinforces	VBZ	reinforce
reinforcing	VBG	reinforce
reins	NNS	rein
reinstalled	VBN	reinstall
reinstated	VBD	reinstate
reinstated	VBN	reinstate
reinstating	VBG	reinstate
reintegrated	VBN	reintegrate
reintroduced	VBN	reintroduce
reinvigorated	VBN	reinvigorate
reiterated	VBD	reiterate
reiterates	VBZ	reiterate
reiterating	VBG	reiterate
rejected	VBD	reject
rejected	VBN	reject
rejecting	VBG	reject
rejections	NNS	rejection
rejects	VBZ	reject
reject	VBP	reject
rejoined	VBD	rejoin
rejoining	VBG	rejoin
rekindling	VBG	rekindle
related	VBD	relate
related	VBN	relate
relates	VBZ	relate
relate	VBP	relate
relating	VBG	relate
relationships	NNS	relationship
relations	NNS	relations
relatives	NNS	relative
relaxed	VBN	relax
relaxing	VBG	relax
relayed	VBD	relay
released	VBD	release
released	VBN	release
release	NNP	release
releases	NNS	release
releases	VBZ	release
releasing	VBG	release
relented	VBD	relent
relenting	VBG	relent
relent	VBP	relent
relied	VBD	rely
relied	VBN	rely
relies	VBZ	rely
relieved	VBD	relieve
relieved	VBN	relieve
relinquished	VBN	relinquish
relished	VBD	relish
relishes	VBZ	relish
relive	VBP	relive
relocated	VBD	relocate
relying	VBG	rely
rely	VBP	rely
remained	VBD	remain
remained	VBN	remain
remaining	VBG	remain
remains	VBZ	remain
remain	VBP	remain
remanded	VBD	remand
remarked	VBD	remark
remarketings	NNS	remarketings
remarks	NNS	remark
remedies	NNS	remedy
remembered	VBD	remember
remembered	VBN	remember
remembering	VBG	remember
remembers	VBZ	remember
remember	VBP	remember
remembrance	NNP	remembrance
reminded	VBD	remind
reminding	VBG	remind
reminds	VBZ	remind
remittances	NNS	remittance
remodeling	VBG	remodel
removed	VBD	remove
removed	VBN	remove
removes	VBZ	remove
removing	VBG	remove
renamed	VBN	rename
rendered	VBN	render
renderings	NNS	rendering
rendering	VBG	render
rendezvoused	VBD	rendezvous
reneging	VBG	renege
renewed	VBD	renew
renewed	VBN	renew
renewing	VBG	renew
renews	VBZ	renew
renounced	VBD	renounce
renouncing	VBG	renounce
renovating	VBG	renovate
rentals	NNS	rental
rented	VBN	rent
renters	NNS	renter
rents	NNS	rent
reopened	VBD	reopen
reopened	VBN	reopen
reopening	VBG	reopen
reorganized	VBN	reorganize
reorganizes	VBZ	reorganize
repaid	VBN	repay
repainted	VBN	repaint
repaired	VBN	repair
repairing	VBG	repair
repair	NNP	repair
repairs	NNS	repair
repair	VBP	repair
reparations	NNS	reparation
repaying	VBG	repay
repayments	NNS	repayment
repealed	VBN	repeal
repeated	VBD	repeat
repeated	VBN	repeat
repeaters	NNS	repeater
repeating	VBG	repeat
repeats	NNS	repeat
repeats	VBZ	repeat
repercussions	NNS	repercussion
replaced	VBD	replace
replaced	VBN	replace
replacements	NNS	replacement
replaces	VBZ	replace
replace	VBP	replace
replacing	VBG	replace
replays	NNS	replay
replenished	VBN	replenish
replicated	VBN	replicate
replicating	VBG	replicate
replied	VBD	reply
replies	NNS	reply
replies	VBZ	reply
reported	VBD	report
reported	VBN	report
reporters	NNS	reporter
reporting	VBG	report
report	NNP	report
reports	NNS	report
reports	VBZ	report
report	VBP	report
repositories	NNS	repository
representations	NNS	representation
representatives	NNP	representative
representatives	NNS	representative
represented	VBD	represent
represented	VBN	represent
representing	VBG	represent
represents	VBZ	represent
represent	VBP	represent
repressing	VBG	repress
reprinted	VBN	reprint
reprints	VBZ	reprint
reproduced	VBD	reproduce
repurchases	NNS	repurchase
reputations	NNS	reputation
requested	VBD	request
requested	VBN	request
requesting	VBG	request
requests	NNS	request
request	VBP	request
required	VBD	require
required	VBN	require
requirements	NNS	requirement
requires	VBZ	require
require	VBP	require
requiring	VBG	require
requisitioned	VBD	requisition
reruns	NNS	rerun
resales	NNS	resale
rescheduled	VBD	reschedule
rescheduled	VBN	reschedule
rescinded	VBD	rescind
rescinding	VBG	rescind
rescued	VBD	rescue
rescues	VBZ	rescue
researched	VBN	research
researchers	NNS	researcher
researches	VBZ	research
reselling	VBG	resell
resells	VBZ	resell
resembles	VBZ	resemble
resemble	VBP	resemble
resembling	VBG	resemble
resented	VBD	resent
resent	VBP	resent
reservations	NNS	reservation
reserved	NNP	reserve
reserved	VBD	reserve
reserved	VBN	reserve
reserves	NNS	reserves
reserving	VBG	reserve
reshaped	VBN	reshape
reshaping	VBG	reshape
reshuffled	VBD	reshuffle
resided	VBN	reside
residents	NNS	resident
resides	VBZ	reside
resignations	NNS	resignation
resigned	VBD	resign
resigned	VBN	resign
resigning	VBG	resign
resistance	NNP	resistance
resisted	VBD	resist
resisted	VBN	resist
resisting	VBG	resist
resolutions	NNS	resolution
resolved	VBD	resolve
resolved	VBN	resolve
resolving	VBG	resolve
resonated	VBN	resonate
resonates	VBZ	resonate
resorts	VBZ	resort
resources	NNS	resource
respected	VBN	respect
respect	NNP	respect
respects	NNS	respect
responded	VBD	respond
responded	VBN	respond
respondents	NNS	respondent
responding	VBG	respond
responds	VBZ	respond
responses	NNS	response
responsibilities	NNS	responsibility
restarted	VBD	restart
restarted	VBN	restart
restarters	NNS	restarters
restated	VBN	restate
restating	VBG	restate
rested	VBD	rest
restored	VBD	restore
restored	VBN	restore
restoring	VBG	restore
restrained	VBD	restrain
restraints	NNS	restraint
restricted	VBN	restrict
restricting	VBG	restrict
restrictions	NNS	restriction
restricts	VBZ	restrict
restrict	VBP	restrict
restructured	VBD	restructure
restructured	VBN	restructure
restructures	VBZ	restructure
restructure	VBP	restructure
restructurings	NNS	restructurings
restructuring	VBG	restructure
rests	VBZ	rest
rest	VBP	rest
resulted	VBD	result
resulted	VBN	result
resulting	VBG	result
result	NNP	result
results	NNS	result
results	VBZ	result
result	VBP	result
resumed	VBD	resume
resumed	VBN	resume
resumes	NNS	resume
resuming	VBG	resume
resurfaced	VBD	resurface
resurrected	VBD	resurrect
resurrected	VBN	resurrect
resurrects	VBZ	resurrect
resuscitating	VBG	resuscitate
retailers	NNS	retailer
retailing	VBG	retail
retails	VBZ	retail
retained	VBD	retain
retained	VBN	retain
retaining	VBG	retain
retains	VBZ	retain
retain	VBP	retain
retaking	VBG	retake
rethinking	VBG	rethink
retired	NNP	retire
retired	VBD	retire
retired	VBN	retire
retires	VBZ	retire
retiring	VBG	retire
retools	VBZ	retool
retracted	VBD	retract
retraining	VBG	retrain
retreated	VBD	retreat
retreating	VBG	retreat
retreats	NNS	retreat
retrieved	VBD	retrieve
retrieved	VBN	retrieve
returned	VBD	return
returned	VBN	return
returning	VBG	return
returns	NNS	return
returns	VBZ	return
return	VBP	return
revalued	VBN	revalue
revamped	VBN	revamp
revamping	VBG	revamp
revealed	VBD	reveal
revealed	VBN	reveal
revealing	VBG	reveal
reveals	VBZ	reveal
reveal	VBP	reveal
revelations	NNS	revelation
reveling	VBG	revel
revels	NNS	revel
revel	VBP	revel
revenues	NNS	revenue
reverberated	VBN	reverberate
reverberating	VBG	reverberate
reverberations	NNS	reverberation
reversed	VBD	reverse
reversed	VBN	reverse
reverse	NNP	reverse
reverses	VBZ	reverse
reversing	VBG	reverse
reverted	VBN	revert
reverts	VBZ	revert
reviewed	VBN	review
reviewing	VBG	review
reviews	NNS	review
reviews	VBZ	review
review	VBP	review
revised	VBD	revise
revised	VBN	revise
revising	VBG	revise
revisions	NNS	revision
revitalized	VBN	revitalize
revitalizing	VBG	revitalize
revivals	NNS	revival
revived	VBN	revive
reviving	VBG	revive
revoked	VBN	revoke
revoking	VBG	revoke
revolutionized	VBD	revolutionize
revolves	VBZ	revolve
revolving	VBG	revolve
revved	VBN	rev
rewarded	VBN	reward
rewarding	VBG	reward
reward	NNP	reward
rewards	NNS	reward
rewards	VBZ	reward
reworked	VBN	rework
rewritten	VBN	rewrite
rhyming	VBG	rhyme
riders	NNS	rider
rides	NNS	ride
ride	VBP	ride
ridiculed	VBN	ridicule
ridicules	VBZ	ridicule
riding	VBG	rid
rid	VBD	rid
rid	VBN	rid
rigged	VBD	rig
righted	VBN	right
rights	NNS	right
rigors	NNS	rigor
riles	VBZ	rile
ringing	VBG	ring
ring	VBP	ring
riots	NNS	riot
ripens	VBZ	ripen
ripped	VBD	rip
ripped	VBN	rip
rippling	VBG	ripple
risen	VBN	rise
rises	NNS	rise
rises	VBZ	rise
rise	VBP	rise
rising	VBG	rise
risked	VBD	risk
risking	VBG	risk
risks	NNS	risk
risks	VBZ	risk
risk	VBP	risk
rites	NNS	rite
rivaling	VBG	rival
rivals	NNS	rival
rivals	VBZ	rival
riveted	VBD	rivet
riveted	VBN	rivet
rivets	NNS	rivet
roadblocks	NNS	roadblock
roads	NNS	roads
roamed	VBD	roam
roam	VBP	roam
roars	VBZ	roar
robbed	VBN	rob
robberies	NNS	robbery
robbers	NNP	robber
robbers	NNS	robber
rocked	VBD	rock
rocked	VBN	rock
rocketed	VBD	rocket
rocketing	VBG	rocket
rocking	VBG	rock
rode	NNP	ride
rode	VBD	ride
roiling	VBG	roil
roles	NNS	role
rolled	VBD	roll
rolled	VBN	roll
rollers	NNS	roller
rolling	VBG	roll
rolls	NNS	roll
rolls	VBZ	roll
roll	VBP	roll
romancing	VBG	romance
roofs	NNS	roof
rooms	NNS	rooms
rooted	VBN	root
rooting	VBG	root
roots	NNS	roots
root	VBP	root
rose	VBD	rise
rotated	VBD	rotate
rotating	VBG	rotate
rotted	VBN	rot
rotting	VBG	rot
rounded	VBD	round
rounded	VBN	round
rounds	NNS	round
routed	VBN	route
routes	NNS	route
routing	VBG	route
rowed	VBD	row
rows	NNS	row
royalties	NNS	royalty
rubbed	VBD	rub
rubs	NNS	rub
ruffled	VBN	ruffle
ruined	VBN	ruin
ruining	VBG	ruin
ruled	VBD	rule
ruled	VBN	rule
rulers	NNS	ruler
rules	NNS	rule
rules	VBZ	rule
rule	VBP	rule
rulings	NNS	ruling
ruling	VBG	rule
rumbled	VBD	rumble
rumbles	VBZ	rumble
rumble	VBP	rumble
rumblings	NNS	rumbling
rumbling	VBG	rumble
ruminated	VBD	ruminate
ruminated	VBN	ruminate
rumored	VBN	rumor
rumors	NNS	rumor
rung	VBN	ring
runners	NNS	runner
running	VBG	run
runs	NNS	run
runs	VBZ	run
run	VBN	run
run	VBP	run
runways	NNS	runway
ruptured	VBD	rupture
rupturing	VBG	rupture
rushed	VBD	rush
rushed	VBN	rush
rushes	VBZ	rush
rushing	VBG	rush
rush	VBP	rush
rusticated	VBN	rusticate
sacked	VBD	sack
sackings	NNS	sacking
sacking	VBG	sack
sacks	NNS	sack
sacrifices	NNS	sacrifice
sacrifices	VBZ	sacrifice
sacrificing	VBG	sacrifice
saddled	VBN	saddle
safeguarded	VBN	safeguard
safeguards	NNS	safeguard
sages	NNS	sage
sagged	VBD	sag
sagging	VBG	sag
said	NNP	say
said	VBD	say
said	VBN	say
sailed	VBD	sail
sailing	VBG	sail
salaries	NNS	salary
sale	NNP	sale
salesmen	NNS	salesman
sales	NNS	sales
saluting	VBG	salute
salvaged	VBN	salvage
sampled	VBD	sample
sampled	VBN	sample
samples	NNS	sample
sanctioned	VBN	sanction
sanctioning	VBG	sanction
sanctions	NNS	sanction
sandwiched	VBD	sandwich
sandwiched	VBN	sandwich
sandwiches	NNS	sandwich
sang	VBD	sing
sanitized	VBN	sanitize
sanitize	VBP	sanitize
sank	VBD	sink
sapped	VBN	sap
sapping	VBG	sap
satisfied	VBN	satisfy
satisfies	VBZ	satisfy
satisfying	VBG	satisfy
saturated	VBD	saturate
saturated	VBN	saturate
sat	VBD	sit
sat	VBN	sit
saved	VBD	save
saved	VBN	save
save	NNP	save
savers	NNS	saver
saves	VBZ	save
savings	NNS	savings
saving	VBG	save
savored	VBD	savor
savoring	VBG	savor
saw	VBD	see
saying	VBG	say
says	VBZ	say
say	VBP	say
scaled	VBD	scale
scaled	VBN	scale
scales	NNS	scale
scaling	VBG	scale
scamper	VBP	scamper
scams	NNS	scam
scandalized	VBD	scandalize
scandals	NNS	scandal
scanning	VBG	scan
scans	VBZ	scan
scared	VBD	scare
scared	VBN	scare
scares	NNS	scare
scarfing	VBG	scarf
scaring	VBG	scare
scattered	VBN	scatter
scavengers	NNS	scavenger
scenarios	NNS	scenario
scenes	NNS	scene
scents	NNS	scent
scheduled	VBD	schedule
scheduled	VBN	schedule
schedules	NNS	schedule
scheduling	VBG	schedule
schemes	NNS	scheme
scholars	NNS	scholar
schoolmates	NNS	schoolmate
schools	NNS	school
sciences	NNS	science
scientists	NNS	scientist
scoffed	VBD	scoff
scoffs	VBZ	scoff
scoff	VBP	scoff
scolded	VBN	scold
scooped	VBD	scoop
scoops	VBZ	scoop
scooted	VBD	scoot
scored	VBD	score
scored	VBN	score
scores	NNS	scores
score	VBP	score
scotched	VBD	scotch
scouring	VBG	scour
scouting	VBG	scout
scowls	NNS	scowl
scrambled	VBD	scramble
scramble	VBP	scramble
scrambling	VBG	scramble
scrap	NNP	scrap
scrapped	VBD	scrap
scrapped	VBN	scrap
scrapping	VBG	scrap
scraps	NNS	scrap
scratched	VBN	scratch
scratching	VBG	scratch
screamed	VBD	scream
screaming	VBG	scream
screams	VBZ	scream
screeched	VBD	screech
screeching	VBG	screech
screening	VBG	screen
screens	NNS	screen
screens	VBZ	screen
screen	VBN	screen
screwed	VBD	screw
scribbled	VBD	scribble
scribbling	VBG	scribble
scribes	NNS	scribe
scrimped	VBD	scrimp
scrimping	VBG	scrimp
scrounged	VBD	scrounge
scrutinized	VBN	scrutinize
scrutinizing	VBG	scrutinize
scurrying	VBG	scurry
scuttled	VBD	scuttle
scuttled	VBN	scuttle
sealed	VBN	seal
sealing	VBG	seal
searched	VBD	search
searches	NNS	search
searching	VBG	search
seasons	NNS	season
seated	VBD	seat
seated	VBN	seat
seats	NNS	seats
seconds	NNS	second
secretaries	NNS	secretary
secrets	NNS	secret
sections	NNS	section
sectors	NNS	sector
secured	VBD	secure
secured	VBN	secure
securing	VBG	secure
securities	NNS	security
security	NNP	security
seducing	VBG	seduce
seeded	VBN	seed
seeds	NNS	seed
seeing	VBG	see
seekers	NNS	seeker
seeking	VBG	seek
seek	NNP	seek
seeks	VBZ	seek
seek	VBP	seek
seemed	VBD	seem
seemed	VBN	seem
seems	NNS	seem
seems	VBZ	seem
seem	VBP	seem
seen	VBN	see
seeped	VBD	seep
sees	VBZ	see
seething	VBG	seethe
see	VBP	see
segments	NNS	segment
segregated	VBN	segregate
seized	VBD	seize
seized	VBN	seize
seizing	VBG	seize
seizures	NNS	seizure
selected	VBD	select
selected	VBN	select
selecting	VBG	select
selections	NNS	selection
selects	VBZ	select
sellers	NNS	sellers
selling	VBG	sell
sell	NNP	sell
selloffs	NNS	selloff
sells	VBZ	sell
sell	VBP	sell
seminars	NNS	seminar
senators	NNS	senator
senders	NNS	sender
sending	VBG	send
sends	VBZ	send
send	VBP	send
sensed	VBD	sense
sense	VBP	sense
sensibilities	NNS	sensibility
sensing	VBG	sense
sensitivities	NNS	sensitivity
sentenced	VBD	sentence
sentenced	VBN	sentence
sentences	NNS	sentence
sentencings	NNS	sentencings
sentiments	NNS	sentiment
sent	VBD	send
sent	VBN	send
separated	VBD	separate
separating	VBG	separate
sequels	NNS	sequel
sequels	VBZ	sequels
sergeants	NNS	sergeant
series	NNP	series
servants	NNS	servant
served	VBD	serve
served	VBN	serve
serves	VBZ	serve
serve	VBP	serve
services	NNS	services
serving	VBG	serve
sessions	NNS	sessions
setbacks	NNS	setback
sets	NNS	set
sets	VBZ	set
setters	NNS	setter
settings	NNS	setting
setting	VBG	set
settled	VBD	settle
settled	VBN	settle
settlements	NNS	settlement
settles	VBZ	settle
settle	VBP	settle
settling	VBG	settle
set	VBD	set
set	VBN	set
set	VBP	set
severed	VBN	sever
severing	VBG	sever
shadowing	VBG	shadow
shadows	NNS	shadow
shags	VBZ	shag
shaken	VBN	shake
shakes	VBZ	shake
shake	VBP	shake
shaking	VBG	shake
shaped	VBN	shape
shapes	VBZ	shape
shape	VBP	shape
shaping	VBG	shape
shards	NNS	shard
shared	VBD	share
shared	VBN	share
shareholders	NNS	shareholder
shareholdings	NNS	shareholding
shares	NNS	share
shares	VBZ	share
share	VBP	share
sharing	VBG	share
sharpening	VBG	sharpen
sharpens	VBZ	sharpen
shattered	VBD	shatter
shattered	VBN	shatter
shattering	VBG	shatter
shaved	VBD	shave
shaves	VBZ	shave
shaving	VBG	shave
sheared	VBD	shear
shedding	VBG	shed
shed	VBD	shed
shed	VBP	shed
sheets	NNS	sheet
sheiks	NNS	sheik
shelled	VBD	shell
shelling	VBG	shell
sheltered	VBN	shelter
sheltering	VBG	shelter
shelters	NNS	shelter
shelved	VBD	shelve
shepherded	VBD	shepherd
sheriffs	NNS	sheriff
shied	VBD	shy
shied	VBN	shy
shielded	VBD	shield
shielded	VBN	shield
shielding	VBG	shield
shifted	VBN	shift
shifting	VBG	shift
shifts	NNS	shift
shift	VBP	shift
shimmered	VBD	shimmer
shining	NNP	shine
shining	VBG	shine
shipments	NNS	shipment
shipped	VBD	ship
shipped	VBN	ship
shippers	NNS	shipper
shipping	VBG	ship
ship	VBP	ship
shirking	VBG	shirk
shivering	VBG	shiver
shivers	NNS	shiver
shocked	VBN	shock
shocks	NNS	shock
shoehorned	VBN	shoehorn
shook	NNP	shake
shook	VBD	shake
shooting	VBG	shoot
shoots	NNS	shoot
shoot	VBP	shoot
shopped	VBD	shop
shoppers	NNS	shopper
shopping	VBG	shop
shores	NNS	shore
shore	VBP	shore
shortages	NNS	shortage
shortcomings	NNS	shortcoming
shortened	VBN	shorten
shorting	VBG	short
shots	NNS	shot
shot	VBD	shoot
shot	VBN	shoot
shoulders	NNS	shoulder
shouted	VBD	shout
shouting	VBG	shout
shouts	VBZ	shout
shoved	VBD	shove
shoves	VBZ	shove
shoving	VBG	shove
showed	VBD	show
showed	VBN	show
showers	NNS	shower
showing	VBG	show
shown	VBN	show
shows	NNP	show
shows	NNS	show
shows	VBZ	show
show	VBP	show
shrank	VBD	shrink
shredded	VBN	shred
shred	VBD	shred
shrines	NNS	shrine
shrinking	VBG	shrink
shriveled	VBD	shrivel
shrouded	VBD	shroud
shrugged	VBD	shrug
shrunk	VBN	shrink
shuffled	VBD	shuffle
shunned	VBD	shun
shunning	VBG	shun
shun	NNP	shun
shun	VBP	shun
shutdowns	NNS	shutdown
shuts	VBZ	shut
shuttered	VBN	shutter
shuttering	VBG	shutter
shutting	VBG	shut
shuttled	VBD	shuttle
shuttled	VBN	shuttle
shuttles	NNS	shuttle
shuttling	VBG	shuttle
shut	VBD	shut
shut	VBN	shut
shying	VBG	shy
siblings	NNS	sibling
sided	VBN	side
sides	NNS	side
sidestepped	VBD	sidestep
sidesteps	VBZ	sidestep
sifted	VBN	sift
sighed	VBD	sigh
sighs	NNS	sigh
sighs	VBZ	sigh
sightings	NNS	sighting
sights	NNS	sight
signaled	VBD	signal
signaled	VBN	signal
signaling	VBG	signal
signals	NNS	signal
signals	VBZ	signal
signal	VBP	signal
signatures	NNS	signature
signed	VBD	sign
signed	VBN	sign
significance	NNP	significance
signing	VBG	sign
signs	NNS	sign
silenced	VBN	silence
silences	NNS	silence
silted	VBN	silt
similarities	NNS	similarity
simmering	VBG	simmer
simplicities	NNS	simplicity
simplified	VBN	simplify
simplifying	VBG	simplify
simplify	VBP	simplify
simulates	VBZ	simulate
simulate	VBP	simulate
simulation	NNP	simulation
simulations	NNS	simulation
simulators	NNS	simulator
singers	NNS	singer
singled	VBD	single
singled	VBN	single
singling	VBG	single
sings	VBZ	sing
sinking	VBG	sink
sins	NNS	sin
siphoned	VBN	siphon
siphoning	VBG	siphon
sipped	VBD	sip
sipping	VBG	sip
sites	NNS	site
sits	VBZ	sit
sitting	VBG	sit
situated	VBD	situate
situated	VBN	situate
situations	NNS	situation
sit	VBP	sit
sizes	NNS	size
size	VBP	size
sizzling	VBG	sizzle
sketches	NNS	sketch
skewed	VBN	skew
skidded	VBD	skid
skids	NNS	skid
skid	VBD	skid
skills	NNS	skill
skins	NNS	skin
skipped	VBD	skip
skipping	VBG	skip
skip	VBP	skip
skirted	VBN	skirt
skirting	VBG	skirt
skirts	VBZ	skirt
skyrocketed	VBD	skyrocket
skyrocketed	VBN	skyrocket
skyrocketing	VBG	skyrocket
slackened	VBN	slacken
slackening	VBG	slacken
slain	VBN	slay
slammed	VBD	slam
slapped	VBD	slap
slaps	VBZ	slap
slashed	VBD	slash
slashed	VBN	slash
slashes	NNS	slash
slashing	VBG	slash
slash	VBP	slash
slated	VBD	slate
slated	VBN	slate
slats	NNS	slat
slaughtered	VBN	slaughter
slay	VBP	slay
sleeping	VBG	sleep
sleeps	VBZ	sleep
sleep	VBP	sleep
slept	VBD	sleep
slicing	VBG	slice
sliding	VBG	slide
slid	VBD	slide
slimming	VBG	slim
slipped	VBD	slip
slipped	VBN	slip
slipping	VBG	slip
slips	VBZ	slip
slip	VBP	slip
slithered	VBD	slither
slithering	VBG	slither
slivered	VBN	sliver
slogs	VBZ	slog
slopes	NNS	slope
slots	NNS	slot
slowdowns	NNS	slowdown
slowed	VBD	slow
slowed	VBN	slow
slowing	VBG	slow
slows	VBZ	slow
slumped	VBD	slump
slumped	VBN	slump
slumping	VBG	slump
slumps	NNS	slump
slurs	NNS	slur
smacks	VBZ	smack
smarting	VBG	smart
smashed	VBD	smash
smashed	VBN	smash
smelled	VBD	smell
smelling	VBG	smell
smells	VBZ	smell
smidgins	NNS	smidgin
smiled	VBD	smile
smiles	NNS	smile
smiling	VBG	smile
smokes	VBZ	smoke
smoke	VBP	smoke
smoking	VBG	smoke
smoldering	VBG	smolder
smolder	VBP	smolder
smoothed	VBN	smooth
smothered	VBN	smother
snagged	VBN	snag
snags	NNS	snag
snakes	NNS	snake
snapped	VBD	snap
snapped	VBN	snap
snapping	VBG	snap
snaps	VBZ	snap
snatched	VBD	snatch
sneaked	VBD	sneak
sneak	VBP	sneak
sniffed	VBD	sniff
sniffing	VBG	sniff
sniffs	VBZ	sniff
sniped	VBD	snipe
snippets	NNS	snippet
sniveling	VBG	snivel
snooping	VBG	snoop
snoring	VBG	snore
snorts	VBZ	snort
snowballed	VBD	snowball
snubbed	VBD	snub
soaking	VBG	soak
soared	VBD	soar
soared	VBN	soar
soaring	VBG	soar
soar	VBP	soar
sobered	VBD	sober
societies	NNS	society
softened	VBN	soften
softening	VBG	soften
softens	VBZ	soften
soiled	VBD	soil
soirees	NNS	soiree
soldiers	NNS	soldier
sold	VBD	sell
sold	VBN	sell
solicitations	NNS	solicitation
solicited	VBN	solicit
soliciting	VBG	solicit
solicits	VBZ	solicit
solutions	NNS	solution
solved	VBN	solve
solves	VBZ	solve
solving	VBG	solve
songs	NNS	song
sons	NNS	son
soothing	VBG	soothe
sorted	VBN	sort
sorting	VBG	sort
sorts	NNS	sort
sought	VBD	seek
sought	VBN	seek
souls	NNS	soul
sounded	VBD	sound
sounding	VBG	sound
sounds	NNS	sound
sounds	VBZ	sound
sources	NNS	source
soured	VBN	sour
sowed	VBD	sow
sows	VBZ	sow
sow	VBP	sow
spanning	VBG	span
spans	NNS	span
spared	VBN	spare
spares	NNS	spare
sparked	VBD	spark
sparked	VBN	spark
sparking	VBG	spark
sparks	NNP	spark
sparks	VBZ	spark
sparred	VBD	spar
spasms	NNS	spasm
spawned	VBD	spawn
spawned	VBN	spawn
spawns	VBZ	spawn
speakers	NNS	speaker
speaking	VBG	speak
speaks	VBZ	speak
speak	VBP	speak
spearheaded	VBD	spearhead
spearheaded	VBN	spearhead
spearheading	VBG	spearhead
specialists	NNS	specialist
specialized	VBN	specialize
specializes	VBZ	specialize
specialize	VBP	specialize
specializing	VBG	specialize
specials	NNS	special
specialties	NNS	specialty
specifications	NNS	specification
specified	VBN	specify
specifies	VBZ	specify
specifying	VBG	specify
specimens	NNS	specimen
speculated	VBD	speculate
speculated	VBN	speculate
speculate	VBP	speculate
speculating	VBG	speculate
speculations	NNS	speculation
speculators	NNS	speculator
sped	VBD	speed
sped	VBN	speed
speeches	NNS	speech
speeding	VBG	speed
speeds	NNS	speed
spelled	VBN	spell
spelling	VBG	spell
spells	VBZ	spell
spending	VBG	spend
spend	NNP	spend
spends	VBZ	spend
spend	VBP	spend
spent	VBD	spend
spent	VBN	spend
spewed	VBD	spew
spewing	VBG	spew
spied	VBD	spy
spies	NNS	spy
spiked	VBN	spike
spilled	VBD	spill
spill	NNP	spill
spills	NNS	spill
spills	VBZ	spill
spinoffs	NNS	spinoffs
spins	VBZ	spin
spiraling	VBG	spiral
spirits	NNS	spirits
splashed	VBD	splash
splits	VBZ	split
split	VBD	split
split	VBN	split
spoiled	VBD	spoil
spoken	VBN	speak
spokesmen	NNS	spokesman
spoke	VBD	speak
sponsored	VBD	sponsor
sponsored	VBN	sponsor
sponsoring	VBG	sponsor
sponsors	NNS	sponsor
sponsors	VBZ	sponsor
spooked	VBD	spook
spooked	VBN	spook
spooks	NNS	spook
sported	VBD	sport
sporting	VBG	sport
sports	NNS	sport
spots	NNS	spots
spots	VBZ	spot
spotted	VBD	spot
spotted	VBN	spot
spotting	VBG	spot
spouse	NNP	spouse
spouses	NNS	spouse
spout	VBP	spout
sprawling	VBG	sprawl
spraying	VBG	spray
spreading	VBG	spread
spreads	NNS	spread
spreads	VBZ	spread
spread	VBD	spread
spread	VBN	spread
spread	VBP	spread
springing	VBG	spring
sprinkled	VBD	sprinkle
sprinkles	NNS	sprinkle
sprinkle	VBP	sprinkle
sprouting	VBG	sprout
sprung	VBN	spring
spun	VBD	spin
spun	VBN	spin
spurned	VBD	spurn
spurning	VBG	spurn
spurred	VBD	spur
spurred	VBN	spur
spurring	VBG	spur
spurs	VBZ	spur
spurted	VBD	spurt
spurts	NNS	spurt
sputter	VBP	sputter
spying	VBG	spy
squabbles	NNS	squabble
squads	NNS	squad
squandered	VBN	squander
squandering	VBG	squander
squared	VBN	square
squaring	VBG	square
squatted	VBN	squat
squeegee	VBP	squeegee
squeezed	VBD	squeeze
squeezed	VBN	squeeze
squeezes	VBZ	squeeze
squeeze	VBP	squeeze
squeezing	VBG	squeeze
squelched	VBN	squelch
squelch	VBP	squelch
squinted	VBD	squint
squinting	VBG	squint
squirming	VBG	squirm
stabbed	VBD	stab
stabbed	VBN	stab
stabbing	VBG	stab
stabilized	VBD	stabilize
stabilized	VBN	stabilize
stabilizes	NNS	stabilize
stabilize	VBP	stabilize
stabilizing	VBG	stabilize
stacked	VBN	stack
stacking	VBG	stack
stacks	NNS	stacks
staffed	VBN	staff
staffers	NNS	staffer
staffs	NNS	staff
staged	VBD	stage
stage	NNP	stage
stages	NNS	stage
stage	VBP	stage
staggered	VBD	stagger
staggering	VBG	stagger
staging	VBG	stage
stagnated	VBD	stagnate
staked	VBN	stake
stakes	NNS	stakes
stalked	VBN	stalk
stalking	VBG	stalk
stalled	VBN	stall
stalling	VBG	stall
stalls	NNS	stall
stalwarts	NNS	stalwart
stampeded	VBN	stampede
stamping	VBG	stamp
stamps	NNS	stamp
standards	NNS	standard
standing	VBG	stand
stands	VBZ	stand
stand	VBP	stand
stared	VBD	stare
starring	VBG	star
stars	NNS	star
stars	VBZ	star
started	VBD	start
started	VBN	start
starters	NNS	starter
starting	VBG	start
starts	NNS	start
starts	VBZ	start
start	VBP	start
starved	VBN	starve
starve	NNP	starve
starving	VBG	starve
stashed	VBD	stash
stated	VBD	state
stated	VBN	state
statements	NNS	statement
states	NNS	state
states	VBZ	state
state	VBP	state
stating	VBG	state
stationed	VBN	station
statistics	NNPS	statistics
statistics	NNP	statistics
statistics	NNS	statistics
statutes	NNS	statute
stayed	VBD	stay
stayed	VBN	stay
staying	VBG	stay
stays	NNS	stays
stays	VBZ	stay
stay	VBP	stay
steadied	VBD	steady
stealing	VBG	steal
steals	VBZ	steal
steaming	VBG	steam
steered	VBD	steer
steered	VBN	steer
steering	VBG	steer
steers	VBZ	steer
stemmed	VBD	stem
stemming	VBG	stem
stems	VBZ	stem
stem	VBP	stem
stepped	VBD	step
stepped	VBN	step
stepping	VBG	step
steps	NNS	steps
steps	VBZ	step
sterilized	VBN	sterilize
sterilizing	VBG	sterilize
sticking	VBG	stick
stick	NNP	stick
sticks	VBZ	stick
stick	VBP	stick
stifles	NNS	stifle
stifling	VBG	stifle
stimulated	VBN	stimulate
stimulating	VBG	stimulate
stimulators	NNS	stimulators
stinging	VBG	sting
stints	NNS	stint
stipulated	VBD	stipulate
stipulates	VBZ	stipulate
stirred	VBD	stir
stirrings	NNS	stirring
stirring	VBG	stir
stirs	NNS	stir
stirs	VBZ	stir
stitched	VBN	stitch
stockbrokers	NNS	stockbroker
stocked	VBN	stock
stockholders	NNS	stockholder
stockholdings	NNS	stockholdings
stocks	NNS	stocks
stocks	VBZ	stock
stoking	VBG	stoke
stolen	VBN	steal
stole	VBD	steal
stomped	VBD	stomp
stomping	VBG	stomp
stoned	VBN	stone
stonewalled	VBD	stonewall
stood	VBD	stand
stood	VBN	stand
stop	NNP	stop
stoppages	NNS	stoppage
stopped	VBD	stop
stopped	VBN	stop
stoppers	NNS	stopper
stopping	VBG	stop
stops	NNS	stop
stops	VBZ	stop
stop	VBP	stop
stored	VBD	store
stores	NNS	store
store	VBP	store
stories	NNS	story
storing	VBG	store
stormed	VBD	storm
storming	VBG	storm
stowed	VBD	stow
straddling	VBG	straddle
strainers	NNS	strainer
straining	VBG	strain
strains	NNS	strain
stranded	VBN	strand
stranding	VBG	strand
strangled	VBN	strangle
strangles	VBZ	strangle
strapped	VBD	strap
strapped	VBN	strap
strategies	NNS	strategy
strategists	NNS	strategist
straying	VBG	stray
streaked	VBD	streak
streamed	VBD	stream
streaming	VBG	stream
streamlining	VBG	streamline
streets	NNS	street
strengthened	VBD	strengthen
strengthened	VBN	strengthen
strengthening	VBG	strengthen
strengthens	VBZ	strengthen
strengths	NNS	strength
stressed	VBD	stress
stressed	VBN	stress
stresses	VBZ	stress
stressing	VBG	stress
stress	VBP	stress
stretched	VBD	stretch
stretched	VBN	stretch
stretches	NNS	stretch
stretches	VBZ	stretch
stretching	VBG	stretch
strikers	NNS	striker
strikes	NNS	strike
strikes	VBZ	strike
strike	VBP	strike
striking	VBG	strike
stripped	VBD	strip
stripped	VBN	strip
stripping	VBG	strip
strips	NNS	strip
striven	VBN	strive
strives	NNS	strive
strive	VBP	strive
striving	VBG	strive
strode	VBD	stride
strokes	NNS	stroke
stroking	VBG	stroke
strolling	VBG	stroll
strove	VBD	strive
struck	VBD	strike
struck	VBN	strike
structured	VBD	structure
structured	VBN	structure
structures	NNS	structure
structuring	VBG	structure
struggled	VBD	struggle
struggled	VBN	struggle
struggles	NNS	struggle
struggles	VBZ	struggle
struggling	VBG	struggle
stuck	VBD	stick
stuck	VBN	stick
studded	VBN	stud
students	NNS	student
studied	VBD	study
studied	VBN	study
studies	NNS	study
studying	VBG	study
study	VBP	study
stuffed	VBD	stuff
stuffing	VBG	stuff
stumbled	VBN	stumble
stumbling	VBG	stumble
stung	VBN	sting
stunned	VBD	stun
stunned	VBN	stun
styled	VBN	style
styles	NNS	style
stymied	VBN	stymie
subcommittees	NNS	subcommittee
subcontractors	NNS	subcontractor
subdued	VBN	subdue
subjected	VBN	subject
subjects	NNS	subject
submits	VBZ	submit
submitted	VBD	submit
submitted	VBN	submit
submitting	VBG	submit
subordinated	VBN	subordinate
subordinates	NNS	subordinate
subpoenas	NNS	subpoena
subscribed	VBN	subscribe
subscribers	NNS	subscriber
subscribes	VBZ	subscribe
subscribe	VBP	subscribe
subscribing	VBG	subscribe
subscriptions	NNS	subscription
subsided	VBD	subside
subsided	VBN	subside
subsidiaries	NNS	subsidiary
subsidies	NNS	subsidy
subsidized	VBN	subsidize
subsidizes	VBZ	subsidize
subsidizing	VBG	subsidize
substituted	VBN	substitute
substitutes	NNS	substitute
substituting	VBG	substitute
subsumed	VBN	subsume
subtitled	VBN	subtitle
subtracted	VBD	subtract
subtracted	VBN	subtract
suburbs	NNS	suburb
subverted	VBN	subvert
subverts	VBZ	subvert
succeeded	VBD	succeed
succeeded	VBN	succeed
succeeding	VBG	succeed
succeeds	VBZ	succeed
succeed	VBP	succeed
successes	NNS	success
successors	NNS	successor
succumbing	VBG	succumb
sucks	VBZ	suck
sued	VBD	sue
sued	VBN	sue
suffered	VBD	suffer
suffered	VBN	suffer
suffering	VBG	suffer
suffers	VBZ	suffer
suffer	VBP	suffer
sufficed	VBD	suffice
suggested	VBD	suggest
suggested	VBN	suggest
suggesting	VBG	suggest
suggestions	NNS	suggestion
suggests	VBZ	suggest
suggest	VBP	suggest
suing	VBG	sue
suited	VBN	suit
suitors	NNS	suitor
suits	NNS	suit
summaries	NNS	summary
summarized	VBD	summarize
summarizing	VBG	summarize
summed	VBD	sum
summers	NNS	summer
summoned	VBD	summon
summoned	VBN	summon
summoning	VBG	summon
sums	NNS	sum
sung	VBN	sing
sunk	VBN	sink
superimposed	VBN	superimpose
superiors	NNS	superior
superseded	VBD	supersede
superstars	NNS	superstar
supervised	VBD	supervise
supervised	VBN	supervise
supervises	VBZ	supervise
supervising	VBG	supervise
supervisors	NNS	supervisor
supplied	VBD	supply
supplied	VBN	supply
suppliers	NNS	supplier
supplies	NNS	supply
supplies	VBZ	supply
supplying	VBG	supply
supply	VBP	supply
supported	VBD	support
supported	VBN	support
supporters	NNS	supporter
supporting	VBG	support
supports	NNS	support
supports	VBZ	support
support	VBP	support
supposed	VBN	suppose
suppose	VBP	suppose
suppressed	VBD	suppress
suppressed	VBN	suppress
suppressors	NNS	suppressor
surfaced	VBD	surface
surfaced	VBN	surface
surfacing	VBG	surface
surged	VBD	surge
surged	VBN	surge
surges	NNS	surge
surges	VBZ	surge
surging	VBG	surge
surmounting	VBG	surmount
surpassed	VBD	surpass
surpassed	VBN	surpass
surpassing	VBG	surpass
surpluses	NNS	surplus
surprised	VBD	surprise
surprised	VBN	surprise
surprises	NNS	surprise
surprising	VBG	surprise
surrendered	VBD	surrender
surrendered	VBN	surrender
surrendering	VBG	surrender
surrender	NNP	surrender
surrounded	VBN	surround
surrounding	VBG	surround
surround	VBP	surround
surtaxes	NNS	surtax
surveyed	VBD	survey
surveyed	VBN	survey
surveying	VBG	survey
surveys	NNS	survey
survived	VBD	survive
survived	VBN	survive
survive	NNP	survive
survives	VBZ	survive
survive	VBP	survive
surviving	VBG	survive
survivors	NNS	survivor
suspected	VBD	suspect
suspected	VBN	suspect
suspecting	VBG	suspect
suspects	NNS	suspect
suspects	VBZ	suspect
suspect	VBP	suspect
suspended	VBD	suspend
suspended	VBN	suspend
suspending	VBG	suspend
suspensions	NNS	suspension
suspicions	NNS	suspicion
sustained	VBD	sustain
sustained	VBN	sustain
sustaining	VBG	sustain
sustains	VBZ	sustain
swallowed	VBN	swallow
swallowing	VBG	swallow
swamped	VBD	swamp
swamped	VBN	swamp
swapping	VBG	swap
swaps	NNS	swap
swarms	NNS	swarm
swathed	VBN	swathe
swayed	VBN	sway
swaying	VBG	sway
sway	VBP	sway
swears	VBZ	swear
swear	VBP	swear
sweated	VBN	sweat
sweating	VBG	sweat
sweat	VBD	sweat
sweat	VBP	sweat
sweepers	NNS	sweeper
sweeping	VBG	sweep
sweeps	NNS	sweep
sweetened	VBD	sweeten
sweetened	VBN	sweeten
swelled	VBD	swell
swelled	VBN	swell
swelling	VBG	swell
swells	VBZ	swell
swell	VBP	swell
swept	VBD	sweep
swept	VBN	sweep
swerve	VBP	swerve
swim	VBP	swim
swindled	VBN	swindle
swings	NNS	swing
swing	VBP	swing
switched	VBD	switch
switched	VBN	switch
switchers	NNS	switcher
switches	NNS	switch
switches	VBZ	switch
switching	VBG	switch
switch	VBP	switch
swiveling	VBG	swivel
swore	VBD	swear
sworn	VBN	swear
swung	NNP	swing
swung	VBD	swing
symbolized	VBN	symbolize
symbolizes	VBZ	symbolize
sympathies	NNS	sympathy
sympathizers	NNS	sympathizer
sympathize	VBP	sympathize
symptoms	NNS	symptom
synchronized	VBN	synchronize
syndicated	VBN	syndicate
syndicates	NNS	syndicate
syndicating	VBG	syndicate
system	NNP	system
systems	NNS	system
tables	NNS	table
tabs	NNS	tab
tacked	VBD	tack
tacking	VBG	tack
tackles	VBZ	tackle
tackling	VBG	tackle
tactics	NNS	tactics
tagged	VBN	tag
tags	NNS	tag
tailing	VBG	tail
tailored	VBN	tailor
tails	NNS	tails
tainted	VBN	taint
taken	VBN	take
takeovers	NNS	takeover
takers	NNS	taker
takes	VBZ	take
take	VBP	take
taking	VBG	take
talents	NNS	talent
tales	NNS	tale
talked	VBD	talk
talked	VBN	talk
talking	VBG	talk
talks	NNS	talks
talks	VBZ	talk
talk	VBP	talk
tallied	VBD	tally
tallying	VBG	tally
taming	VBG	tame
tampering	VBG	tamper
tangled	VBN	tangle
tangle	VBP	tangle
tangoed	VBN	tango
tanned	VBN	tan
taped	VBD	tape
taped	VBN	tape
tapering	VBG	taper
tapers	NNS	taper
tapers	VBZ	taper
tapes	NNS	tape
tapped	VBD	tap
tapped	VBN	tap
tapping	VBG	tap
taps	NNP	tap
targeted	VBD	target
targeted	VBN	target
targeting	VBG	target
targets	NNS	target
targets	VBZ	target
target	VBP	target
tariffs	NNS	tariff
tarnished	VBD	tarnish
tarnished	VBN	tarnish
tarred	VBD	tar
tasks	NNS	task
tastes	NNS	taste
taught	VBD	teach
taught	VBN	teach
taxed	VBN	tax
taxes	NNS	tax
teachers	NNS	teacher
teaches	VBZ	teach
teaching	VBG	teach
teach	NNP	teach
teach	VBP	teach
teamed	VBD	team
teaming	VBG	team
teams	NNS	team
tearing	VBG	tear
teased	VBN	tease
teaspoons	NNS	teaspoon
technicians	NNS	technician
techniques	NNS	technique
technocrats	NNS	technocrat
technologies	NNS	technology
teemed	VBD	teem
teeming	VBG	teem
telegraphed	VBD	telegraph
telephoned	VBD	telephone
telephoning	VBG	telephone
televised	VBN	televise
tellers	NNS	teller
telling	VBG	tell
tells	VBZ	tell
tell	VBP	tell
temperatures	NNS	temperature
tempered	VBN	temper
tempted	VBD	tempt
tempts	VBZ	tempt
tempt	VBP	tempt
tenants	NNS	tenant
tended	VBD	tend
tended	VBN	tend
tendencies	NNS	tendency
tendered	VBN	tender
tendering	VBG	tender
tenders	NNS	tender
tending	VBG	tend
tends	VBZ	tend
tend	VBP	tend
tenets	NNS	tenet
tensions	NNS	tension
tens	NNS	ten
tenths	NNS	tenth
termed	VBD	term
termed	VBN	term
terminated	VBD	terminate
terminated	VBN	terminate
terminations	NNS	termination
terms	NNS	terms
terrified	VBN	terrify
territories	NNS	territory
tested	VBD	test
tested	VBN	test
testified	VBD	testify
testifies	VBZ	testify
testifying	VBG	testify
testify	VBP	testify
testing	VBG	test
tests	NNS	test
tests	VBZ	test
test	VBP	test
texts	NNS	text
thanked	VBD	thank
thanking	VBG	thank
thanks	NNS	thanks
thefts	NNS	theft
themes	NNS	theme
theories	NNS	theory
theorists	NNS	theorist
theorized	VBD	theorize
therapists	NNS	therapist
thieves	NNS	thief
things	NNS	things
thinking	VBG	think
thinks	VBZ	think
think	VBP	think
thinned	VBN	thin
thirds	NNS	third
thoughts	NNS	thought
thought	VBD	think
thought	VBN	think
thousands	NNS	thousand
thrashed	VBD	thrash
thrashing	VBG	thrash
threatened	VBD	threaten
threatened	VBN	threaten
threatening	VBG	threaten
threatens	VBZ	threaten
threaten	VBP	threaten
threat	NNP	threat
threats	NNS	threat
threw	VBD	throw
thrilled	VBN	thrill
thrills	VBZ	thrill
thrives	VBZ	thrive
thrive	VBP	thrive
thriving	VBG	thrive
throats	NNS	throat
throwers	NNS	thrower
throwing	VBG	throw
thrown	VBN	throw
throws	VBZ	throw
throw	VBP	throw
thrusting	VBG	thrust
thrust	VBD	thrust
thrust	VBN	thrust
thumbs	NNS	thumb
thundered	VBD	thunder
thwarted	VBN	thwart
ticketed	VBD	ticket
tickets	NNS	ticket
tides	NNS	tide
tied	VBD	tie
tied	VBN	tie
ties	NNS	tie
ties	VBZ	tie
tightened	VBD	tighten
tightened	VBN	tighten
tightening	VBG	tighten
tilted	VBN	tilt
tilts	NNS	tilt
timed	VBN	time
time	NNP	time
times	NNS	times
timing	VBG	time
tinges	NNS	tinge
tinkered	VBN	tinker
tinkering	VBG	tinker
tins	NNS	tin
tip	NNP	tip
tipped	VBD	tip
tips	NNS	tip
tipsters	NNS	tipster
tiptoed	VBN	tiptoe
tissues	NNS	tissue
titans	NNS	titan
titled	VBD	title
titled	VBN	title
titles	NNS	title
toasted	VBD	toast
toeholds	NNS	toehold
toes	NNS	toe
toiling	VBG	toil
toil	VBP	toil
told	VBD	tell
told	VBN	tell
tolls	NNS	toll
toned	VBN	tone
tones	NNS	tone
tonnages	NNS	tonnage
tons	NNS	tons
took	VBD	take
tooling	VBG	tool
tools	NNS	tool
topics	NNS	topic
topped	VBD	top
topped	VBN	top
topping	VBG	top
toppled	VBD	topple
toppled	VBN	topple
tops	NNS	top
tops	VBZ	top
top	VBP	top
torched	VBD	torch
torched	VBN	torch
tore	VBD	tear
torments	VBZ	torment
torn	VBN	tear
torture	VBP	torture
tossed	VBD	toss
tossed	VBN	toss
tossers	NNS	tosser
tossing	VBG	toss
totaled	VBD	total
totaled	VBN	total
totaling	VBG	total
totalling	VBG	total
totals	NNS	total
totals	VBZ	total
total	VBP	total
toted	VBN	tote
toting	VBG	tot
tottering	VBG	totter
touched	VBD	touch
touched	VBN	touch
touches	NNS	touch
touching	VBG	touch
toured	VBD	tour
touring	VBG	tour
tourists	NNS	tourist
tours	NNS	tour
touted	VBD	tout
touting	VBG	tout
touts	VBZ	tout
towering	VBG	tower
towns	NNS	town
toying	VBG	toy
traced	VBN	trace
traces	NNS	trace
tracing	VBG	trace
tracked	VBD	track
tracked	VBN	track
tracking	VBG	track
tracks	NNS	track
tracks	VBZ	track
track	VBP	track
tracts	NNS	tract
traded	VBD	trade
traded	VBN	trade
trademarks	NNS	trademark
traders	NNS	trader
trades	NNS	trade
trades	VBZ	trade
trade	VBP	trade
trading	VBG	trade
traditionalists	NNS	traditionalist
traditions	NNS	tradition
traduced	VBN	traduce
traffickers	NNS	trafficker
trafficking	NNP	trafficking
trailed	VBD	trail
trailed	VBN	trail
trailing	VBG	trail
trails	VBZ	trail
trained	VBN	train
training	VBG	train
trains	NNS	train
tramping	VBG	tramp
trampled	VBN	trample
transacted	VBN	transact
transactions	NNS	transactions
transcripts	NNS	transcript
transferred	VBD	transfer
transferred	VBN	transfer
transferring	VBG	transfer
transfers	NNS	transfer
transfers	VBZ	transfer
transformed	VBD	transform
transformed	VBN	transform
transforming	VBG	transform
transforms	VBZ	transform
transfusions	NNS	transfusion
translated	VBD	translate
translated	VBN	translate
translating	VBG	translate
translations	NNS	translation
transmissions	NNS	transmission
transmitted	VBD	transmit
transmitted	VBN	transmit
transmitting	VBG	transmit
transmogrified	VBD	transmogrify
transplanted	VBN	transplant
transplanting	VBG	transplant
transplants	NNS	transplant
transported	VBD	transport
transported	VBN	transport
transporting	VBG	transport
transports	VBZ	transport
trapped	VBD	trap
trapped	VBN	trap
trappings	NNS	trappings
traps	NNS	trap
trashing	VBG	trash
traumas	NNS	trauma
traumatized	VBN	traumatize
travails	NNS	travail
traveled	VBD	travel
traveled	VBN	travel
travelers	NNS	traveler
traveling	NNP	travel
traveling	VBG	travel
travels	VBZ	travel
travel	VBP	travel
treasurers	NNS	treasurer
treasuries	NNS	treasuries
treated	VBD	treat
treated	VBN	treat
treating	VBG	treat
treatments	NNS	treatment
treats	VBZ	treat
treat	VBP	treat
trekked	VBD	trek
trembling	VBG	tremble
tremors	NNS	tremor
trending	VBG	trend
trends	NNS	trend
trespasses	NNS	trespass
trials	NNS	trial
tributes	NNS	tribute
trickling	VBG	trickle
tricks	NNS	trick
tried	VBD	try
tried	VBN	try
tries	VBZ	try
triggered	VBD	trigger
triggered	VBN	trigger
triggering	VBG	trigger
triggers	NNS	trigger
trigger	VBP	trigger
trillions	NNS	trillion
trimmed	VBD	trim
trimmed	VBN	trim
trimming	VBG	trim
trim	NNP	trim
tripled	VBD	triple
tripled	VBN	triple
tripling	VBG	triple
trips	NNS	trip
triumphed	VBD	triumph
troops	NNS	troops
trotted	VBD	trot
trotted	VBN	trot
trotting	VBG	trot
troubled	VBD	trouble
troubled	VBN	trouble
troubles	NNS	trouble
troubling	VBG	trouble
trudging	VBG	trudge
trumpeting	VBG	trumpet
trumpets	VBZ	trumpet
trundles	VBZ	trundle
trunks	NNS	trunks
trusted	VBD	trust
trusted	VBN	trust
trustee	NNP	trustee
trustees	NNS	trustee
trust	NNP	trust
trusts	NNS	trust
truths	NNS	truth
trying	VBG	try
try	VBP	try
tucked	VBD	tuck
tucked	VBN	tuck
tugged	VBD	tug
tugging	VBG	tug
tuitions	NNS	tuition
tumbled	VBD	tumble
tumbles	NNS	tumble
tumbles	VBZ	tumble
tumbling	VBG	tumble
tumors	NNS	tumor
tuned	VBD	tune
tuned	VBN	tune
tuning	VBG	tune
turmoils	NNS	turmoil
turnarounds	NNS	turnaround
turned	VBD	turn
turned	VBN	turn
turning	VBG	turn
turn	NNP	turn
turns	NNS	turn
turns	VBZ	turn
turn	VBP	turn
twiddling	VBG	twiddle
twisted	VBN	twist
twists	NNS	twist
tying	VBG	tie
typed	VBN	type
types	NNS	type
typified	VBD	typify
typifies	VBZ	typify
ulcers	NNS	ulcer
uncertainties	NNS	uncertainty
uncovered	VBD	uncover
uncovered	VBN	uncover
uncovering	VBG	uncover
undercutting	VBG	undercut
undercut	VBD	undercut
underestimated	VBD	underestimate
underestimated	VBN	underestimate
undergirding	VBG	undergird
undergoing	VBG	undergo
undergo	VBP	undergo
underlined	VBD	underline
underlying	VBG	underlie
undermined	VBD	undermine
undermined	VBN	undermine
undermine	VBP	undermine
undermining	VBG	undermine
underperformed	VBN	underperform
underperforms	VBZ	underperform
underpinned	VBN	underpin
underscored	VBD	underscore
underscored	VBN	underscore
underscores	VBZ	underscore
underscore	VBP	underscore
underscoring	VBG	underscore
understanding	VBG	understand
understands	VBZ	understand
understand	VBP	understand
understated	VBN	understate
understate	VBP	understate
understating	VBG	understate
understood	VBD	understand
understood	VBN	understand
undertaken	VBN	undertake
undertakings	NNS	undertaking
undertaking	VBG	undertake
undertones	NNS	undertone
undertook	VBD	undertake
undervalued	VBN	undervalue
undervalued	VBZ	undervalue
underwent	VBD	undergo
underwriters	NNS	underwriter
underwrites	VBZ	underwrite
underwrite	VBP	underwrite
underwriting	VBG	underwrite
underwritten	VBN	underwrite
undid	VBD	undo
undone	VBN	undo
undulate	VBP	undulate
unearthed	VBD	unearth
unfolding	VBG	unfold
unfolds	VBZ	unfold
unhinged	VBN	unhinge
unified	VBN	unify
unionized	VBD	unionize
unions	NNS	union
united	VBN	unite
unites	VBZ	unite
unitholders	NNS	unitholders
units	NNS	unit
unleashed	VBD	unleash
unleashed	VBN	unleash
unleashes	VBZ	unleash
unleashing	VBG	unleash
unleash	VBP	unleash
unloaded	VBN	unload
unloading	VBG	unload
unlocked	VBD	unlock
unlocks	VBZ	unlock
unlock	VBP	unlock
unmasks	VBZ	unmask
unnerved	VBD	unnerve
unnerving	VBG	unnerve
unraveled	VBD	unravel
unraveled	VBN	unravel
unrolls	VBZ	unroll
unroll	VBP	unroll
unsettled	VBD	unsettle
unsettled	VBN	unsettle
unveiled	VBD	unveil
unveiled	VBN	unveil
unveiling	VBG	unveil
unveils	VBZ	unveil
unwinding	VBG	unwind
updated	VBN	update
updates	NNS	update
updating	VBG	update
upgraded	VBD	upgrade
upgraded	VBN	upgrade
upgrades	NNS	upgrade
upgrading	VBG	upgrade
upheavals	NNS	upheaval
upheld	VBD	uphold
upheld	VBN	uphold
upholding	VBG	uphold
upped	VBD	up
upping	VBG	up
uprooted	VBD	uproot
upset	VBN	upset
ups	NNS	ups
urged	VBD	urge
urged	VBN	urge
urges	VBZ	urge
urge	VBP	urge
urging	VBG	urge
used	VBD	use
used	VBN	use
users	NNS	user
uses	NNS	use
uses	VBZ	use
use	VBP	use
ushered	VBD	usher
ushering	VBG	usher
ushers	NNS	usher
using	VBG	use
utilities	NNS	utility
utterances	NNS	utterance
uttered	VBD	utter
vacancies	NNS	vacancy
vacated	VBD	vacate
vacated	VBN	vacate
vacating	VBG	vacate
vacationers	NNS	vacationer
vacationing	VBG	vacation
vagaries	NNS	vagary
validating	VBG	validate
valuations	NNS	valuation
valued	VBD	value
valued	VBN	value
value	NNP	value
values	NNS	values
values	VBZ	value
value	VBP	value
valuing	VBG	value
valves	NNS	valve
vanished	VBN	vanish
vanishes	VBZ	vanish
vanishing	VBG	vanish
vanish	VBP	vanish
variables	NNS	variable
variations	NNS	variation
varied	VBN	vary
varies	VBZ	vary
varieties	NNS	variety
varying	VBG	vary
vary	VBP	vary
vassals	NNS	vassal
vaults	NNS	vault
veering	VBG	veer
vehicles	NNS	vehicle
veiled	VBN	veil
vending	VBG	vend
vendors	NNS	vendor
ventilated	VBD	ventilate
ventures	NNS	venture
venturing	VBG	venture
verdicts	NNS	verdict
verged	VBD	verge
verified	VBN	verify
versions	NNS	version
vessels	NNS	vessel
vested	VBN	vest
veterans	NNS	veteran
vetoed	VBD	veto
vetoed	VBN	veto
vetoes	NNS	veto
vetoing	VBG	veto
vexed	VBN	vex
vibrating	VBG	vibrate
victimized	VBN	victimize
victims	NNS	victim
victories	NNS	victory
videos	NNS	video
viewed	VBD	view
viewed	VBN	view
viewers	NNS	viewers
viewing	VBG	view
viewpoints	NNS	viewpoint
views	NNS	view
views	VBZ	view
view	VBP	view
vignettes	NNS	vignette
villages	NNS	village
vindicated	VBN	vindicate
violated	VBD	violate
violated	VBN	violate
violates	VBZ	violate
violate	VBP	violate
violating	VBG	violate
violations	NNS	violation
virtues	NNS	virtue
visionaries	NNS	visionary
visions	NNS	vision
visited	VBD	visit
visited	VBN	visit
visiting	NNP	visit
visiting	VBG	visit
visitors	NNS	visitor
visits	NNS	visit
visits	VBZ	visit
visit	VBP	visit
visualizing	NNP	visualize
voiced	VBD	voice
voiced	VBN	voice
voices	NNS	voice
voices	VBZ	voice
voided	VBN	void
volume	NNP	volume
volumes	NNS	volume
volunteered	VBD	volunteer
voted	VBD	vote
voted	VBN	vote
voters	NNS	voter
votes	NNS	vote
votes	VBZ	vote
voting	VBG	vote
vouchers	NNS	voucher
vowed	VBD	vow
vowing	VBG	vow
vows	VBZ	vow
vying	VBG	vie
waffled	VBD	waffle
waffled	VBN	waffle
wafting	VBG	waft
waged	VBD	wage
wages	NNS	wages
waging	VBG	wage
wailing	VBG	wail
waited	VBD	wait
waited	VBN	wait
waiting	VBG	wait
waits	VBZ	wait
wait	VBP	wait
waived	VBN	waive
waivers	NNS	waiver
waives	VBZ	waive
waiving	VBG	waive
walked	VBD	walk
walking	NNP	walk
walking	VBG	walk
walkouts	NNS	walkout
walks	NNS	walk
walks	VBZ	walk
walk	VBP	walk
wallowing	VBG	wallow
walls	NNS	wall
wandering	VBG	wander
waned	VBD	wane
wanes	NNS	wane
wanes	VBZ	wane
waning	VBG	wane
wanted	VBD	want
wanted	VBN	want
wanting	VBG	want
wants	VBZ	want
want	VBD	want
want	VBP	want
wardens	NNS	warden
wares	NNS	ware
warmed	VBN	warm
warming	VBG	warm
warned	VBD	warn
warned	VBN	warn
warnings	NNS	warning
warning	VBG	warn
warns	VBZ	warn
warn	VBP	warn
warranties	NNS	warranty
warrants	NNS	warrant
wars	NNS	war
washed	VBN	wash
washing	VBG	wash
wasted	VBN	waste
wastes	NNS	waste
wasting	VBG	waste
watchdogs	NNS	watchdog
watched	VBD	watch
watched	VBN	watch
watchers	NNS	watcher
watches	NNS	watch
watches	VBZ	watch
watching	VBG	watch
watch	VBP	watch
watered	VBN	water
watts	NNS	watts
waved	VBD	wave
wavelengths	NNS	wavelength
wavered	VBD	waver
wavering	VBG	waver
waves	NNS	wave
waving	VBG	wave
waxed	VBN	wax
ways	NNS	ways
weakened	VBD	weaken
weakened	VBN	weaken
weakening	VBG	weaken
weakens	NNP	weaken
weakens	VBZ	weaken
weaknesses	NNS	weakness
weapons	NNS	weapon
wearing	VBG	wear
wears	VBZ	wear
wear	VBP	wear
weaving	VBG	weave
webs	NNS	web
wedded	VBN	wed
weddings	NNS	wedding
wedged	VBN	wedge
weds	VBZ	wed
wed	VBN	wed
weeks	NNS	week
weeping	VBG	weep
weighed	VBD	weigh
weighed	VBN	weigh
weighing	VBG	weigh
weighs	VBZ	weigh
weighted	VBN	weight
weightings	NNS	weighting
weigh	VBP	weigh
welcomed	VBD	welcome
welcomed	VBN	welcome
welcomes	VBZ	welcome
welcoming	VBG	welcome
welded	VBN	weld
wells	NNS	wells
went	VBD	go
wept	VBP	weep
whacked	VBN	whack
wheeled	VBN	wheel
wheezing	VBG	wheeze
whimpers	NNS	whimper
whims	NNS	whim
whipped	VBN	whip
whippings	NNS	whipping
whipping	VBG	whip
whipsawed	VBN	whipsaw
whips	VBZ	whip
whirlwinds	NNS	whirlwind
whirring	VBG	whirr
whisked	VBN	whisk
whispered	VBN	whisper
whispering	VBG	whisper
whistled	VBN	whistle
whittled	VBN	whittle
wholesaling	VBG	wholesale
whoosh	VBP	whoosh
widened	VBD	widen
widened	VBN	widen
widening	VBG	widen
widens	VBZ	widen
wielding	VBG	wield
wields	VBZ	wield
wiggled	VBD	wiggle
wiggling	VBG	wiggle
windfalls	NNS	windfall
winding	VBG	wind
windows	NNS	windows
winds	NNS	wind
wind	VBP	wind
wings	NNS	wings
winking	VBG	wink
winners	NNS	winner
winning	VBG	win
wins	NNS	win
wins	VBZ	win
win	VBP	win
wiped	VBD	wipe
wiped	VBN	wipe
wiping	VBG	wipe
wired	VBN	wire
wiretaps	NNS	wiretap
wished	VBD	wish
wished	VBN	wish
wishes	NNS	wish
wishes	VBZ	wish
wishing	VBG	wish
wish	VBP	wish
withdrawals	NNS	withdrawal
withdrawing	VBG	withdraw
withdrawn	VBN	withdraw
withdrew	VBD	withdraw
wither	VBP	wither
withheld	VBD	withhold
withheld	VBN	withhold
withholding	VBG	withhold
withstanding	VBG	withstand
withstood	VBD	withstand
witnessed	VBN	witness
witnesses	NNS	witness
witnessing	VBG	witness
wives	NNS	wife
woes	NNS	woe
woke	VBD	wake
womanizing	VBG	womanize
wondered	VBD	wonder
wondering	VBG	wonder
wonders	VBZ	wonder
wonder	VBP	wonder
won	VBD	win
won	VBN	win
won	VBP	win
wooed	VBN	woo
wooing	VBG	woo
worded	VBN	word
words	NNS	words
wore	VBD	wear
worked	VBD	work
worked	VBN	work
workers	NNS	worker
working	NNP	work
workings	NNS	workings
working	VBG	work
work	NNP	work
works	NNS	works
works	VBZ	work
work	VBP	work
worried	VBD	worry
worried	VBN	worry
worries	NNS	worry
worries	VBZ	worry
worrying	VBG	worry
worry	VBP	worry
worsened	VBN	worsen
worsening	VBG	worsen
wounded	VBN	wound
wounds	NNS	wound
wound	VBD	wind
wows	VBZ	wow
wracked	VBD	wrack
wrack	VBP	wrack
wrangling	VBG	wrangle
wrapped	VBD	wrap
wrapped	VBN	wrap
wrapping	VBG	wrap
wraps	VBZ	wrap
wreaked	VBD	wreak
wreaking	VBG	wreak
wrecked	VBD	wreck
wrecking	VBG	wreck
wrenched	VBN	wrench
wrested	VBN	wrest
wrestles	VBZ	wrestle
wrestling	VBG	wrestle
wrists	NNS	wrist
writedowns	NNS	writedowns
writers	NNS	writer
writes	VBZ	write
write	VBP	write
writhing	VBG	writhe
writings	NNS	writings
writing	VBG	write
written	VBN	write
wronged	VBN	wrong
wrote	VBD	write
yanked	VBD	yank
yanked	VBN	yank
yanking	VBG	yank
years	NNS	years
yelled	VBD	yell
yelling	VBG	yell
yells	VBZ	yell
yielded	VBD	yield
yielding	VBG	yield
yield	NNP	yield
yields	NNS	yield
yields	VBZ	yield
yield	VBD	yield
yield	VBP	yield
zapping	VBG	zap
zeroing	VBG	zero
zones	NNS	zone
zoomed	VBD	zoom
